こうしょう | kōshō | negotiation | [sound:ic_jp_negotiation.mp3]
けいやく | keiyaku | contract | [sound:ic_jp_contract.mp3]
ビジネス | bijinesu | business | [sound:ic_jp_business.mp3]
とりひき | torihiki | deal | [sound:ic_jp_deal.mp3]
ちゅうもん | chūmon | order | [sound:ic_jp_order.mp3]
かいけい | kaikei | accounting | [sound:ic_jp_accounting.mp3]
せんぱい | senpai | superior | [sound:ic_jp_superior.mp3]
かいしゃ | kaisha | company | [sound:ic_jp_company.mp3]
ボーナス | bōnasu | bonus | [sound:ic_jp_bonus.mp3]
きゅうりょう | kyūryō | salary | [sound:ic_jp_salary.mp3]
きゅうりょう | kyūryō | wage | [sound:ic_jp_wage.mp3]
きゅうりょう | kyūryō | salary | [sound:ic_jp_salary.mp3]
きゅうりょう | kyūryō | wage | [sound:ic_jp_wage.mp3]
しゃちょう | shachō | president | [sound:ic_jp_president.mp3]
はんばい | hanbai | sale | [sound:ic_jp_sale.mp3]
アイティーぶもん | aitī-bumon | IT department | [sound:ic_jp_IT-department.mp3]
しゅっちょう | shucchō | business trip | [sound:ic_jp_business-trip.mp3]
マーケティング | māketingu | marketing | [sound:ic_jp_marketing.mp3]
ぶしょ | busho | department | [sound:ic_jp_department.mp3]
さんぎょう | sangyō | industry | [sound:ic_jp_industry.mp3]
ラジオ | rajio | radio | [sound:ic_jp_radio.mp3]
いんさつする | insatsu suru | print | [sound:ic_jp_print.mp3]
しゅっぱんする | shuppan suru | publish | [sound:ic_jp_publish.mp3]
パンフレット | panfuretto | pamphlet | [sound:ic_jp_pamphlet.mp3]
しょうせつ | shōsetsu | novel | [sound:ic_jp_novel.mp3]
そうしんする | sōshin suru | transmit | [sound:ic_jp_transmit.mp3]
しんぶんしゃ | shinbunsha | newspaper publisher | [sound:ic_jp_newspaper-publisher.mp3]
ほうどう | hōdō | report | [sound:ic_jp_report.mp3]
ていしゅつする | teishutsu suru | submit | [sound:ic_jp_submit.mp3]
ニュース | nyūsu | news | [sound:ic_jp_news.mp3]
ざっし | zasshi | magazine | [sound:ic_jp_magazine.mp3]
じょうほう | jōhō | information | [sound:ic_jp_information.mp3]
テレビきょく | terebikyoku | TV station | [sound:ic_jp_TV-station.mp3]
へんしゅうする | henshū suru | edit | [sound:ic_jp_edit.mp3]
ばんぐみ | bangumi | program | [sound:ic_jp_program.mp3]
ばんぐみ | bangumi | broadcast | [sound:ic_jp_broadcast.mp3]
ほうそう | hōsō | program | [sound:ic_jp_program.mp3]
ほうそう | hōsō | broadcast | [sound:ic_jp_broadcast.mp3]
インターネット | intānetto | Internet | [sound:ic_jp_Internet.mp3]
チャンネル | channeru | channel | [sound:ic_jp_channel.mp3]
メディア | media | media | [sound:ic_jp_media.mp3]
きょく | kyoku | station | [sound:ic_jp_station.mp3]
いんさつ | insatsu | printing | [sound:ic_jp_printing.mp3]
やくいんしつ | yakuin shitsu | boardroom | [sound:ic_jp_boardroom.mp3]
ぎちょう | gichō | chairman | [sound:ic_jp_chairman.mp3]
つうやく | tsūyaku | interpreter | [sound:ic_jp_interpreter.mp3]
ほんやくか | hon'yakuka | translator | [sound:ic_jp_translator.mp3]
かいけいし | kaikeishi | accountant | [sound:ic_jp_accountant.mp3]
べんごし | bengoshi | lawyer | [sound:ic_jp_lawyer.mp3]
おもしろい | omoshiroi | humorous | [sound:ic_jp_humorous.mp3]
じょうだんをいう | jōdan o iu | joke | [sound:ic_jp_joke.mp3]
いんしょう | inshō | impression | [sound:ic_jp_impression.mp3]
かんがえかた | kangae-kata | way of thinking | [sound:ic_jp_way-of-thinking.mp3]
はんたい | hantai | objection | [sound:ic_jp_objection.mp3]
かっきのある | kakki no aru | energetic | [sound:ic_jp_energetic.mp3]
はなしあい | hanashiai | discussion | [sound:ic_jp_discussion.mp3]
じゅうよう | jūyō | important | [sound:ic_jp_important.mp3]
かいぎ | kaigi | meeting | [sound:ic_jp_meeting.mp3]
はんたいする | hantai suru | disagree | [sound:ic_jp_disagree.mp3]
たもつ | tamotsu | maintain | [sound:ic_jp_maintain.mp3]
かえる | kaeru | change | [sound:ic_jp_change.mp3]
きめる | kimeru | decide | [sound:ic_jp_decide.mp3]
はんたいする | hantai suru | oppose | [sound:ic_jp_oppose.mp3]
どういする | dōi suru | agree | [sound:ic_jp_agree.mp3]
はっぴょうする | happyō suru | announce | [sound:ic_jp_announce.mp3]
きく | kiku | hear | [sound:ic_jp_hear.mp3]
かいぎをひらく | kaigi o hiraku | hold a meeting | [sound:ic_jp_hold-a-meeting.mp3]
しょうにんする | shōnin suru | approve | [sound:ic_jp_approve.mp3]
ひはんする | hihan suru | criticize | [sound:ic_jp_criticize.mp3]
ていあんする | teian suru | put forward | [sound:ic_jp_put-forward.mp3]
しじする | shiji suru | support | [sound:ic_jp_support.mp3]
けいかくする | keikaku suru | plan | [sound:ic_jp_plan.mp3]
しんじる | shinjiru | believe | [sound:ic_jp_believe.mp3]
ちょうさ | chōsa | research | [sound:ic_jp_research.mp3]
ようきゅう | yōkyū | request | [sound:ic_jp_request.mp3]
せつめいする | setsumei suru | explain | [sound:ic_jp_explain.mp3]
こうしょうする | kōshō suru | negotiate | [sound:ic_jp_negotiate.mp3]
けいかく | keikaku | plan | [sound:ic_jp_plan.mp3]
あう | au | meet | [sound:ic_jp_meet.mp3]
かいていする | kaitei suru | revise | [sound:ic_jp_revise.mp3]
じゅうやく | jūyaku | director | [sound:ic_jp_director.mp3]
こうじょう | kōjō | factory | [sound:ic_jp_factory.mp3]
せいさん | seisan | output | [sound:ic_jp_output.mp3]
ろうどうしゃ | rōdōsha | workforce | [sound:ic_jp_workforce.mp3]
じゅうぎょういん | jūgyōin | employee | [sound:ic_jp_employee.mp3]
そざい | sozai | material | [sound:ic_jp_material.mp3]
のうぎょう | nōgyō | agriculture | [sound:ic_jp_agriculture.mp3]
ぶひん | buhin | part | [sound:ic_jp_part.mp3]
きかい | kikai | machine | [sound:ic_jp_machine.mp3]
セメント | semento | cement | [sound:ic_jp_cement.mp3]
せきたん | sekitan | coal | [sound:ic_jp_coal.mp3]
ガス | gasu | gas | [sound:ic_jp_gas.mp3]
せんい | sen'i | textile | [sound:ic_jp_textile.mp3]
でんき | denki | electricity | [sound:ic_jp_electricity.mp3]
にゅうりょく | nyūryoku | input | [sound:ic_jp_input.mp3]
つり | tsuri | fishing | [sound:ic_jp_fishing.mp3]
ぎょぎょう | gyogyō | fishing | [sound:ic_jp_fishing.mp3]
かんこうぎょう | kankōgyō | tourism | [sound:ic_jp_tourism.mp3]
ゆしゅつする | yushutsu suru | export | [sound:ic_jp_export.mp3]
ゆにゅうする | yunyū suru | import | [sound:ic_jp_import.mp3]
くるま | kuruma | car | [sound:ic_jp_car.mp3]
くるま | kuruma | automobile | [sound:ic_jp_automobile.mp3]
じどうしゃ | jidōsha | car | [sound:ic_jp_car.mp3]
じどうしゃ | jidōsha | automobile | [sound:ic_jp_automobile.mp3]
へる | heru | decrease | [sound:ic_jp_decrease.mp3]
ガソリン | gasorin | gasoline | [sound:ic_jp_gasoline.mp3]
マフラー | mafurā | scarf | [sound:ic_jp_scarf.mp3]
ベルト | beruto | belt | [sound:ic_jp_belt.mp3]
ぼうし | bōshi | hat | [sound:ic_jp_hat.mp3]
てぶくろ | tebukuro | glove | [sound:ic_jp_glove.mp3]
うでどけい | udedokei | wristwatch | [sound:ic_jp_wristwatch.mp3]
めがね | megane | eyeglasses | [sound:ic_jp_eyeglasses.mp3]
めがね | megane | glasses | [sound:ic_jp_glasses.mp3]
メガネ | megane | eyeglasses | [sound:ic_jp_eyeglasses.mp3]
メガネ | megane | glasses | [sound:ic_jp_glasses.mp3]
イヤリング | iyaringu | earring | [sound:ic_jp_earring.mp3]
サングラス | sangurasu | sunglasses | [sound:ic_jp_sunglasses.mp3]
ネックレス | nekkuresu | necklace | [sound:ic_jp_necklace.mp3]
うでどけい | udedokei | watch | [sound:ic_jp_watch.mp3]
かさ | kasa | umbrella | [sound:ic_jp_umbrella.mp3]
ハンガー | hangā | hanger | [sound:ic_jp_hanger.mp3]
ぬの | nuno | cloth | [sound:ic_jp_cloth.mp3]
コート | kōto | coat | [sound:ic_jp_coat.mp3]
ジャケット | jaketto | jacket | [sound:ic_jp_jacket.mp3]
オーバーコート | ōbākōto | overcoat | [sound:ic_jp_overcoat.mp3]
レインコート | rein kōto | raincoat | [sound:ic_jp_raincoat.mp3]
ジャージ | jāji | sweat suit | [sound:ic_jp_sweat-suit.mp3]
セーター | sētā | sweater | [sound:ic_jp_sweater.mp3]
ベスト | besuto | vest | [sound:ic_jp_vest.mp3]
ジーンズ | jīnzu | jeans | [sound:ic_jp_jeans.mp3]
ふく | fuku | clothes | [sound:ic_jp_clothes.mp3]
シャツ | shatsu | shirt | [sound:ic_jp_shirt.mp3]
ズボン | zubon | pants | [sound:ic_jp_pants.mp3]
ドレス | doresu | dress | [sound:ic_jp_dress.mp3]
ながそで | nagasode | long-sleeved | [sound:ic_jp_long-sleeved.mp3]
はんそでの | hansode no | short-sleeved | [sound:ic_jp_short-sleeved.mp3]
ポケット | poketto | pocket | [sound:ic_jp_pocket.mp3]
ボタン | botan | button | [sound:ic_jp_button.mp3]
ゴムバンド | gomu bando | elastic band | [sound:ic_jp_elastic-band.mp3]
そで | sode | sleeve | [sound:ic_jp_sleeve.mp3]
えり | eri | collar | [sound:ic_jp_collar.mp3]
ふく | fuku | clothing | [sound:ic_jp_clothing.mp3]
ティーシャツ | tīshatsu | T-shirt | [sound:ic_jp_T-shirt.mp3]
ぬぐ | nugu | take off | [sound:ic_jp_take-off.mp3]
しちゃくする | shichaku suru | try on | [sound:ic_jp_try-on.mp3]
きる | kiru | put on | [sound:ic_jp_put-on.mp3]
いろがあわない | iro ga awanai | clash | [sound:ic_jp_clash.mp3]
せんたくする | sentaku suru | wash clothes | [sound:ic_jp_wash-clothes.mp3]
ぬう | nuu | sew | [sound:ic_jp_sew.mp3]
ほしゅうする | hoshū suru | mend | [sound:ic_jp_mend.mp3]
あむ | amu | knit | [sound:ic_jp_knit.mp3]
そめる | someru | dye | [sound:ic_jp_dye.mp3]
いふくをあわせる | ifuku o awaseru | fit a garment | [sound:ic_jp_fit-a-garment.mp3]
あう | au | go with | [sound:ic_jp_go-with.mp3]
あう | au | match | [sound:ic_jp_match.mp3]
にあう | niau | go with | [sound:ic_jp_go-with.mp3]
にあう | niau | match | [sound:ic_jp_match.mp3]
せんたくする | sentaku suru | wash | [sound:ic_jp_wash.mp3]
みじかい | mijikai | short | [sound:ic_jp_short.mp3]
やわらかい | yawarakai | soft | [sound:ic_jp_soft.mp3]
ブランド | burando | brand | [sound:ic_jp_brand.mp3]
サイズ | saizu | size | [sound:ic_jp_size.mp3]
スタイル | sutairu | style | [sound:ic_jp_style.mp3]
りゅうこうの | ryūkō no | fashionable | [sound:ic_jp_fashionable.mp3]
ぶかぶか | bukabuka | loose | [sound:ic_jp_loose.mp3]
きつい | kitsui | tight | [sound:ic_jp_tight.mp3]
せいりせいとんされた | seiri seiton sareta | neat | [sound:ic_jp_neat.mp3]
シルク | shiruku | silk | [sound:ic_jp_silk.mp3]
エスサイズの | esu saizu no | small (S) | [sound:ic_jp_small-(S).mp3]
エムサイズの | emu saizu no | medium | [sound:ic_jp_medium.mp3]
エルサイズ | eru saizu | Large (L) | [sound:ic_jp_Large-(L).mp3]
エックスエルサイズ | ekkusu eru saizu | Extra Large (XL) | [sound:ic_jp_Extra-Large-(XL).mp3]
てづくりの | tezukuri no | handmade | [sound:ic_jp_handmade.mp3]
めん | men | cotton | [sound:ic_jp_cotton.mp3]
けいと | keito | wool | [sound:ic_jp_wool.mp3]
あさ | asa | linen | [sound:ic_jp_linen.mp3]
ネクタイ | nekutai | necktie | [sound:ic_jp_necktie.mp3]
ネクタイ | nekutai | tie | [sound:ic_jp_tie.mp3]
ネクタイ | nekutai | necktie | [sound:ic_jp_necktie.mp3]
ネクタイ | nekutai | tie | [sound:ic_jp_tie.mp3]
スーツ | sūtsu | suit | [sound:ic_jp_suit.mp3]
がうん | gaun | gown | [sound:ic_jp_gown.mp3]
タキシード | takishīdo | tuxedo | [sound:ic_jp_tuxedo.mp3]
サンダル | sandaru | sandal | [sound:ic_jp_sandal.mp3]
くつ | kutsu | shoe | [sound:ic_jp_shoe.mp3]
くつした | kutsushita | sock | [sound:ic_jp_sock.mp3]
スニーカー | sunīkā | sneaker | [sound:ic_jp_sneaker.mp3]
ブーツ | būtsu | boot | [sound:ic_jp_boot.mp3]
スリッパ | surippa | slipper | [sound:ic_jp_slipper.mp3]
ゆびわ | yubiwa | ring | [sound:ic_jp_ring.mp3]
きんいろ | kin'iro | gold | [sound:ic_jp_gold.mp3]
ぎん | gin | silver | [sound:ic_jp_silver.mp3]
けしょう | keshō | makeup | [sound:ic_jp_makeup.mp3]
くちべに | kuchibeni | lipstick | [sound:ic_jp_lipstick.mp3]
あいらいん | airain | eyeliner | [sound:ic_jp_eyeliner.mp3]
ほおべに | hoobeni | blush | [sound:ic_jp_blush.mp3]
マニキュア | manikyua | nail polish | [sound:ic_jp_nail-polish.mp3]
したぎ | shitagi | underwear | [sound:ic_jp_underwear.mp3]
はだぎ | hadagi | undershirt | [sound:ic_jp_undershirt.mp3]
パジャマ | pajama | pajamas | [sound:ic_jp_pajamas.mp3]
ブラジャー | burajā | brassiere | [sound:ic_jp_brassiere.mp3]
ボクサーパンツ | bokusā pantsu | boxer shorts | [sound:ic_jp_boxer-shorts.mp3]
ねまき | namaki | nightgown | [sound:ic_jp_nightgown.mp3]
パンティー | pantī | panties | [sound:ic_jp_panties.mp3]
みずぎ | mizugi | swimsuit | [sound:ic_jp_swimsuit.mp3]
ブラウス | burausu | blouse | [sound:ic_jp_blouse.mp3]
スカート | sukāto | skirt | [sound:ic_jp_skirt.mp3]
ミニスカート | mini sukāto | mini-skirt | [sound:ic_jp_mini-skirt.mp3]
ひ | hi | day | [sound:ic_jp_day.mp3]
しゅう | shū | week | [sound:ic_jp_week.mp3]
つき | tsuki | month | [sound:ic_jp_month.mp3]
とし | toshi | year | [sound:ic_jp_year.mp3]
しゅくじつ | shukujitsu | holiday | [sound:ic_jp_holiday.mp3]
きょう | kyō | today | [sound:ic_jp_today.mp3]
あした | ashita | tomorrow | [sound:ic_jp_tomorrow.mp3]
きのう | kinō | yesterday | [sound:ic_jp_yesterday.mp3]
あさって | asatte | day after tomorrow | [sound:ic_jp_day-after-tomorrow.mp3]
カレンダー | karendā | calendar | [sound:ic_jp_calendar.mp3]
おととい | ototoi | day before yesterday | [sound:ic_jp_day-before-yesterday.mp3]
びょう | byō | second | [sound:ic_jp_second.mp3]
じかん | jikan | hour | [sound:ic_jp_hour.mp3]
ふん | fun | minute | [sound:ic_jp_minute.mp3]
ごぜん | gozen | AM | [sound:ic_jp_AM.mp3]
しょうご | shōgo | noon | [sound:ic_jp_noon.mp3]
まよなか | mayonaka | midnight | [sound:ic_jp_midnight.mp3]
じ | ji | o'clock | [sound:ic_jp_o'clock.mp3]
じじゅうごふんまえ | ~ji jū-go-fun mae | quarter to (hour) | [sound:ic_jp_quarter-to-(hour).mp3]
はん | han | half past | [sound:ic_jp_half-past.mp3]
ごご | gogo | PM | [sound:ic_jp_PM.mp3]
とけい | tokei | clock | [sound:ic_jp_clock.mp3]
じゅうごふんすぎ | jū-go-fun sugi | quarter after (hour) | [sound:ic_jp_quarter-after-(hour).mp3]
あかるい | akarui | light | [sound:ic_jp_light.mp3]
くろい | kuroi | black | [sound:ic_jp_black.mp3]
ちゃいろい | chairoi | brown | [sound:ic_jp_brown.mp3]
はいいろの | haiiro no | gray | [sound:ic_jp_gray.mp3]
しろい | shiroi | white | [sound:ic_jp_white.mp3]
きんいろの | kin'iro no | gold | [sound:ic_jp_gold.mp3]
むらさきの | murasaki no | purple | [sound:ic_jp_purple.mp3]
あかい | akai | red | [sound:ic_jp_red.mp3]
みどり | midori | green | [sound:ic_jp_green.mp3]
あおい | aoi | blue | [sound:ic_jp_blue.mp3]
きいろい | kiiroi | yellow | [sound:ic_jp_yellow.mp3]
ピンクの | pinku no | pink | [sound:ic_jp_pink.mp3]
ぎん | gin | silver | [sound:ic_jp_silver.mp3]
ベージュ | bēju | beige | [sound:ic_jp_beige.mp3]
あかるい | akarui | bright | [sound:ic_jp_bright.mp3]
いろ | iro | color | [sound:ic_jp_color.mp3]
インディゴ | indigo | indigo | [sound:ic_jp_indigo.mp3]
オレンジいろ | orenji iro | orange | [sound:ic_jp_orange.mp3]
ももいろ | momo'iro | peach | [sound:ic_jp_peach.mp3]
こい | koi | dark | [sound:ic_jp_dark.mp3]
もらう | morau | receive | [sound:ic_jp_receive.mp3]
できる | dekiru | can | [sound:ic_jp_can.mp3]
さがす | sagasu | search | [sound:ic_jp_search.mp3]
とる | toru | take | [sound:ic_jp_take.mp3]
つかう | tsukau | use | [sound:ic_jp_use.mp3]
する | suru | do | [sound:ic_jp_do.mp3]
いく | iku | go | [sound:ic_jp_go.mp3]
くる | kuru | come | [sound:ic_jp_come.mp3]
いう | iu | say | [sound:ic_jp_say.mp3]
でんわする | denwa suru | call | [sound:ic_jp_call.mp3]
わらう | warau | laugh | [sound:ic_jp_laugh.mp3]
つくる | tsukuru | make | [sound:ic_jp_make.mp3]
みる | miru | see | [sound:ic_jp_see.mp3]
みつける | mitsukeru | find | [sound:ic_jp_find.mp3]
はなす | hanasu | talk | [sound:ic_jp_talk.mp3]
あげる | ageru | give | [sound:ic_jp_give.mp3]
やすむ | yasumu | rest | [sound:ic_jp_rest.mp3]
かんじる | kanjiru | feel | [sound:ic_jp_feel.mp3]
かく | kaku | draw | [sound:ic_jp_draw.mp3]
ほしい | hoshii | want | [sound:ic_jp_want.mp3]
おく | oku | put | [sound:ic_jp_put.mp3]
おもいだす | omoidasu | remember | [sound:ic_jp_remember.mp3]
もつ | motsu | hold | [sound:ic_jp_hold.mp3]
おわる | owaru | finish | [sound:ic_jp_finish.mp3]
ちょうせんする | chōsen suru | try | [sound:ic_jp_try.mp3]
はじめる | hajimeru | start | [sound:ic_jp_start.mp3]
はかる | hakaru | measure | [sound:ic_jp_measure.mp3]
つづける | tsuzukeru | keep | [sound:ic_jp_keep.mp3]
なる | naru | become | [sound:ic_jp_become.mp3]
たすける | tasukeru | help | [sound:ic_jp_help.mp3]
ならう | narau | learn | [sound:ic_jp_learn.mp3]
うごく | ugoku | move | [sound:ic_jp_move.mp3]
まつ | matsu | wait | [sound:ic_jp_wait.mp3]
おそれる | osoreru | fear | [sound:ic_jp_fear.mp3]
にる | niru | resemble | [sound:ic_jp_resemble.mp3]
そんけいする | sonkei suru | respect | [sound:ic_jp_respect.mp3]
かんしゃする | kansha suru | thank | [sound:ic_jp_thank.mp3]
あいする | aisuru | love | [sound:ic_jp_love.mp3]
ひつよう | hitsuyō | need | [sound:ic_jp_need.mp3]
よむ | yomu | read | [sound:ic_jp_read.mp3]
たつ | tatsu | stand | [sound:ic_jp_stand.mp3]
あう | au | see | [sound:ic_jp_see.mp3]
みる | miru | watch | [sound:ic_jp_watch.mp3]
はずす | hazusu | miss | [sound:ic_jp_miss.mp3]
はいる | hairu | enter | [sound:ic_jp_enter.mp3]
うれしい | ureshii | happy | [sound:ic_jp_happy.mp3]
かなしい | kanashii | sad | [sound:ic_jp_sad.mp3]
おこっている | okotte iru | angry | [sound:ic_jp_angry.mp3]
とおい | tōi | far | [sound:ic_jp_far.mp3]
ちいさい | chiisai | small | [sound:ic_jp_small.mp3]
よい | yoi | good | [sound:ic_jp_good.mp3]
きれい | kirei | beautiful | [sound:ic_jp_beautiful.mp3]
よわい | yowai | weak | [sound:ic_jp_weak.mp3]
つよい | tsuyoi | strong | [sound:ic_jp_strong.mp3]
みにくい | minikui | ugly | [sound:ic_jp_ugly.mp3]
おもしろい | omoshiroi | funny | [sound:ic_jp_funny.mp3]
むずかしい | muzukashii | difficult | [sound:ic_jp_difficult.mp3]
かんたん | kantan | easy | [sound:ic_jp_easy.mp3]
わるい | warui | bad | [sound:ic_jp_bad.mp3]
きれい | kirei | clean | [sound:ic_jp_clean.mp3]
きたない | kitanai | dirty | [sound:ic_jp_dirty.mp3]
ちかい | chikai | near | [sound:ic_jp_near.mp3]
ひくい | hikui | low | [sound:ic_jp_low.mp3]
たかい | takai | high | [sound:ic_jp_high.mp3]
つまらない | tsumaranai | boring | [sound:ic_jp_boring.mp3]
しげきてき | shigeki-teki | exciting | [sound:ic_jp_exciting.mp3]
やすい | yasui | cheap | [sound:ic_jp_cheap.mp3]
こうか | kōka | expensive | [sound:ic_jp_expensive.mp3]
いそがしい | isogashii | busy | [sound:ic_jp_busy.mp3]
しんせつ | shinsetsu | kind | [sound:ic_jp_kind.mp3]
こわい | kowai | scary | [sound:ic_jp_scary.mp3]
つめたい | tsumetai | cold | [sound:ic_jp_cold.mp3]
きょうみぶかい | kyōmibukai | interesting | [sound:ic_jp_interesting.mp3]
あつい | atsui | hot | [sound:ic_jp_hot.mp3]
まじめ | majime | serious | [sound:ic_jp_serious.mp3]
いじわる | ijiwaru | mean | [sound:ic_jp_mean.mp3]
たいくつした | taikutsu shita | bored | [sound:ic_jp_bored.mp3]
つかれた | tsukareta | tired | [sound:ic_jp_tired.mp3]
まずい | mazui | disgusting | [sound:ic_jp_disgusting.mp3]
おいしい | oishii | delicious | [sound:ic_jp_delicious.mp3]
くつろいだ | kutsuroida | relaxing | [sound:ic_jp_relaxing.mp3]
まんぞくした | manzoku shita | satisfied | [sound:ic_jp_satisfied.mp3]
おちついた | ochitsuita | calm | [sound:ic_jp_calm.mp3]
あたたかい | atatakai | warm | [sound:ic_jp_warm.mp3]
にんきがある | ninki ga aru | popular | [sound:ic_jp_popular.mp3]
いらだたしい | iradatashii | annoying | [sound:ic_jp_annoying.mp3]
ひろい | hiroi | wide | [sound:ic_jp_wide.mp3]
せまい | semai | narrow | [sound:ic_jp_narrow.mp3]
かたい | katai | hard | [sound:ic_jp_hard.mp3]
かるい | karui | light | [sound:ic_jp_light.mp3]
くらい | kurai | dark | [sound:ic_jp_dark.mp3]
すずしい | suzushii | cool | [sound:ic_jp_cool.mp3]
ふまん | fuman | dissatisfied | [sound:ic_jp_dissatisfied.mp3]
いたい | itai | painful | [sound:ic_jp_painful.mp3]
たいしたことがない | taishita koto ga nai | insignificant | [sound:ic_jp_insignificant.mp3]
きぼうにみちた | kibō ni michita | hopeful | [sound:ic_jp_hopeful.mp3]
かっこいい | kakkoii | cool | [sound:ic_jp_cool.mp3]
はずかしい | hazukashii | shy | [sound:ic_jp_shy.mp3]
きんちょうする | kinchō suru | nervous | [sound:ic_jp_nervous.mp3]
こうふんする | kōfun suru | excited | [sound:ic_jp_excited.mp3]
はずかしがる | hazukashigaru | embarrassed | [sound:ic_jp_embarrassed.mp3]
ふかい | fukai | deep | [sound:ic_jp_deep.mp3]
あさい | asai | shallow | [sound:ic_jp_shallow.mp3]
おかねもちの | o-kanemochi no | rich | [sound:ic_jp_rich.mp3]
びんぼう | binbō | poor | [sound:ic_jp_poor.mp3]
ゆうめい | yūmei | famous | [sound:ic_jp_famous.mp3]
けいしきばらない | keishikibaranai | casual | [sound:ic_jp_casual.mp3]
はじめまして。 | Hajimemashite. | Nice to meet you. | [sound:ic_jp_Nice-to-meet-you..mp3]
おげんきですか。 | O-genki desu ka. | How are you? | [sound:ic_jp_How-are-you?.mp3]
げんきです。 | Genki desu. | I'm good. | [sound:ic_jp_I'm-good..mp3]
ありがとう。 | Arigatō. | Thank you! | [sound:ic_jp_Thank-you!.mp3]
なんじですか。 | Nan-ji desu ka. | What time is it? | [sound:ic_jp_What-time-is-it?.mp3]
はい | hai | yes | [sound:ic_jp_yes.mp3]
いいえ。 | Iie. | No. | [sound:ic_jp_No..mp3]
すばらしい！ | Subarashii! | Awesome! | [sound:ic_jp_Awesome!.mp3]
おいしい！ | Oishii! | Delicious! | [sound:ic_jp_Delicious!.mp3]
すきです。 | Suki desu. | I like it. | [sound:ic_jp_I-like-it..mp3]
きらいです。 | Kirai desu. | I don't like it. | [sound:ic_jp_I-don't-like-it..mp3]
ありがとう。 | Arigatō. | Thanks. | [sound:ic_jp_Thanks..mp3]
たすけて！ | Tasukete! | Help! | [sound:ic_jp_Help!.mp3]
ごめんなさい。 | Gomennasai. | I'm sorry. | [sound:ic_jp_I'm-sorry..mp3]
きにしないで。 | Ki ni shinai de. | Don't worry. | [sound:ic_jp_Don't-worry..mp3]
もんだいありません。 | Mondai arimasen. | No problem. | [sound:ic_jp_No-problem..mp3]
すみません。 | Sumimasen. | Excuse me. | [sound:ic_jp_Excuse-me..mp3]
いいですよ。 | Ii desu yo. | It's okay. | [sound:ic_jp_It's-okay..mp3]
ほんとう？ | Hontō? | Really? | [sound:ic_jp_Really?.mp3]
わたしは～です。 | Watashi wa ~desu. | I'm...(____). | [sound:ic_jp_I'm...(____)..mp3]
おねがいします。 | Onegai shimasu. | Please. | [sound:ic_jp_Please..mp3]
ゆるしてください。 | Yurushite kudasai. | Please forgive me. | [sound:ic_jp_Please-forgive-me..mp3]
～をください | ~o kudasai | I'd like... | [sound:ic_jp_I'd-like....mp3]
～したい | ~shitai | I'd like to...(verb). | [sound:ic_jp_I'd-like-to...(verb)..mp3]
ほんとう | hontō | True. | [sound:ic_jp_True..mp3]
たしかに。 | Tashika ni. | True. | [sound:ic_jp_True..mp3]
まちがった | machigatta | False. | [sound:ic_jp_False..mp3]
いいんですよ。 | Ii n desu yo. | That's all right. | [sound:ic_jp_That's-all-right..mp3]
わたしは、それがきらいです。 | Watashi wa, sore ga kirai desu. | I dislike it. | [sound:ic_jp_I-dislike-it..mp3]
わたしはこっちがいいです。 | Watashi wa kocchi ga ii desu. | I like this. | [sound:ic_jp_I-like-this..mp3]
ください。 | Kudasai. | Please. | [sound:ic_jp_Please..mp3]
モニター | monitā | monitor | [sound:ic_jp_monitor.mp3]
キーボード | kībōdo | keyboard | [sound:ic_jp_keyboard.mp3]
ヘッドフォン | heddofon | headphones | [sound:ic_jp_headphones.mp3]
プリンター | purintā | printer | [sound:ic_jp_printer.mp3]
ノートパソコン | nōtopasokon | laptop computer | [sound:ic_jp_laptop-computer.mp3]
マウス | mausu | mouse | [sound:ic_jp_mouse.mp3]
スピーカー | supīkā | speaker | [sound:ic_jp_speaker.mp3]
ウェブカメラ | webu kamera | webcam | [sound:ic_jp_webcam.mp3]
マイク | maiku | microphone | [sound:ic_jp_microphone.mp3]
デスクトップパソコン | desukutoppu pasokon | desktop computer | [sound:ic_jp_desktop-computer.mp3]
つける | tsukeru | turn on | [sound:ic_jp_turn-on.mp3]
けす | kesu | turn off | [sound:ic_jp_turn-off.mp3]
がいしょくする | gaishoku suru | eat out | [sound:ic_jp_eat-out.mp3]
でんわする | denwa suru | telephone | [sound:ic_jp_telephone.mp3]
でんわする | denwa suru | call | [sound:ic_jp_call.mp3]
でんわする | denwa suru | telephone | [sound:ic_jp_telephone.mp3]
でんわ | denwa | telephone | [sound:ic_jp_telephone.mp3]
べんきょうする | benkyō suru | study | [sound:ic_jp_study.mp3]
はたらく | hataraku | work | [sound:ic_jp_work.mp3]
しゅっせきする | shusseki suru | attend | [sound:ic_jp_attend.mp3]
メールする | mēru suru | e-mail | [sound:ic_jp_e-mail.mp3]
インターネットをする | intānetto o suru | surf the internet | [sound:ic_jp_surf-the-internet.mp3]
りょうりする | ryōri suru | cook | [sound:ic_jp_cook.mp3]
かえる | kaeru | return | [sound:ic_jp_return.mp3]
ふろにはいる | furo ni hairu | bathe | [sound:ic_jp_bathe.mp3]
ねる | neru | sleep | [sound:ic_jp_sleep.mp3]
くつろぐ | kutsurogu | relax | [sound:ic_jp_relax.mp3]
シャワーをあびる | shawā o abiru | shower | [sound:ic_jp_shower.mp3]
うんどうする | undō suru | exercise | [sound:ic_jp_exercise.mp3]
おふろ | o-furo | bath | [sound:ic_jp_bath.mp3]
おきる | okiru | wake up | [sound:ic_jp_wake-up.mp3]
つうきんする | tsūkin suru | commute | [sound:ic_jp_commute.mp3]
たべる | taberu | eat | [sound:ic_jp_eat.mp3]
みがく | migaku | brush | [sound:ic_jp_brush.mp3]
あらう | arau | wash | [sound:ic_jp_wash.mp3]
でる | deru | leave | [sound:ic_jp_leave.mp3]
はをみがく | ha o migaku | brush one's teeth | [sound:ic_jp_brush-one's-teeth.mp3]
げつようび | getsu-yōbi | Monday | [sound:ic_jp_Monday.mp3]
かようび | ka-yōbi | Tuesday | [sound:ic_jp_Tuesday.mp3]
すいようび | sui-yōbi | Wednesday | [sound:ic_jp_Wednesday.mp3]
もくようび | moku-yōbi | Thursday | [sound:ic_jp_Thursday.mp3]
きんようび | kin-yōbi | Friday | [sound:ic_jp_Friday.mp3]
どようび | do-yōbi | Saturday | [sound:ic_jp_Saturday.mp3]
にちようび | nichi-yōbi | Sunday | [sound:ic_jp_Sunday.mp3]
まえ | mae | front | [sound:ic_jp_front.mp3]
うしろ | ushiro | back | [sound:ic_jp_back.mp3]
ひがし | higashi | east | [sound:ic_jp_east.mp3]
にし | nishi | west | [sound:ic_jp_west.mp3]
きた | kita | north | [sound:ic_jp_north.mp3]
みなみ | minami | south | [sound:ic_jp_south.mp3]
そと | soto | outside | [sound:ic_jp_outside.mp3]
なか | naka | inside | [sound:ic_jp_inside.mp3]
ひだり | hidari | left | [sound:ic_jp_left.mp3]
みぎ | migi | right | [sound:ic_jp_right.mp3]
ポンド | pondo | pound | [sound:ic_jp_pound.mp3]
マイル | mairu | mile | [sound:ic_jp_mile.mp3]
フィート | fīto | foot | [sound:ic_jp_foot.mp3]
インチ | inchi | inch | [sound:ic_jp_inch.mp3]
リットル | rittoru | liter | [sound:ic_jp_liter.mp3]
キログラム | kiroguramu | kilogram | [sound:ic_jp_kilogram.mp3]
センチメートル | senchimētoru | centimeter | [sound:ic_jp_centimeter.mp3]
グラム | guramu | gram | [sound:ic_jp_gram.mp3]
メートル | mētoru | meter | [sound:ic_jp_meter.mp3]
キロメートル | kiromētoru | kilometer | [sound:ic_jp_kilometer.mp3]
クレジットカード | kurejittokādo | credit card | [sound:ic_jp_credit-card.mp3]
こぎって | kogitte | check | [sound:ic_jp_check.mp3]
こうか | kōka | coin | [sound:ic_jp_coin.mp3]
かね | kane | money | [sound:ic_jp_money.mp3]
デビットカード | debitto kādo | debit card | [sound:ic_jp_debit-card.mp3]
しへい | shihei | bill | [sound:ic_jp_bill.mp3]
ごがつ | go-gatsu | May | [sound:ic_jp_May.mp3]
いちがつ | ichi-gatsu | January | [sound:ic_jp_January.mp3]
にがつ | ni-gatsu | February | [sound:ic_jp_February.mp3]
さんがつ | san-gatsu | March | [sound:ic_jp_March.mp3]
しがつ | shi-gatsu | April | [sound:ic_jp_April.mp3]
ろくがつ | roku-gatsu | June | [sound:ic_jp_June.mp3]
しちがつ | shichi-gatsu | July | [sound:ic_jp_July.mp3]
はちがつ | hachi-gatsu | August | [sound:ic_jp_August.mp3]
くがつ | ku-gatsu | September | [sound:ic_jp_September.mp3]
じゅうがつ | jū-gatsu | October | [sound:ic_jp_October.mp3]
じゅういちがつ | jūichi-gatsu | November | [sound:ic_jp_November.mp3]
じゅうにがつ | jū ni-gatsu | December | [sound:ic_jp_December.mp3]
れい | rei | zero | [sound:ic_jp_zero.mp3]
いち | ichi | one | [sound:ic_jp_one.mp3]
に | ni | two | [sound:ic_jp_two.mp3]
さん | san | three | [sound:ic_jp_three.mp3]
し、よん | shi, yon | four | [sound:ic_jp_four.mp3]
ご | go | five | [sound:ic_jp_five.mp3]
ろく | roku | six | [sound:ic_jp_six.mp3]
しち、なな | shichi, nana | seven | [sound:ic_jp_seven.mp3]
はち | hachi | eight | [sound:ic_jp_eight.mp3]
きゅう | kyū | nine | [sound:ic_jp_nine.mp3]
じゅう | jū | ten | [sound:ic_jp_ten.mp3]
ごひゃく | go-hyaku | five hundred | [sound:ic_jp_five-hundred.mp3]
きゅうひゃくきゅうじゅうきゅう | kyū-hyaku kyū-jū kyū | nine hundred ninety nine | [sound:ic_jp_nine-hundred-ninety-nine.mp3]
ひゃくいち | hyaku ichi | one hundred one | [sound:ic_jp_one-hundred-one.mp3]
よんひゃく | yon-hyaku | four hundred | [sound:ic_jp_four-hundred.mp3]
はっぴゃく | ha-ppyaku | eight hundred | [sound:ic_jp_eight-hundred.mp3]
にひゃく | ni-hyaku | two hundred | [sound:ic_jp_two-hundred.mp3]
さんびゃく | san-byaku | three hundred | [sound:ic_jp_three-hundred.mp3]
ろっぴゃく | ro-ppyaku | six hundred | [sound:ic_jp_six-hundred.mp3]
ななひゃく | nana-hyaku | seven hundred | [sound:ic_jp_seven-hundred.mp3]
きゅうひゃく | kyū-hyaku | nine hundred | [sound:ic_jp_nine-hundred.mp3]
じゅういち | jū ichi | eleven | [sound:ic_jp_eleven.mp3]
じゅうに | jū ni | twelve | [sound:ic_jp_twelve.mp3]
じゅうさん | jū san | thirteen | [sound:ic_jp_thirteen.mp3]
じゅうよん、じゅうし | jū yon, jū shi | fourteen | [sound:ic_jp_fourteen.mp3]
じゅうご | jū go | fifteen | [sound:ic_jp_fifteen.mp3]
じゅうろく | jū roku | sixteen | [sound:ic_jp_sixteen.mp3]
じゅうしち、じゅうなな | jū nana, jū shichi | seventeen | [sound:ic_jp_seventeen.mp3]
じゅうはち | jū hachi | eighteen | [sound:ic_jp_eighteen.mp3]
じゅうきゅう | jū kyū | nineteen | [sound:ic_jp_nineteen.mp3]
にじゅう | ni-jū | twenty | [sound:ic_jp_twenty.mp3]
にじゅういち | ni-jū ichi | twenty-one | [sound:ic_jp_twenty-one.mp3]
にじゅうに | ni-jū ni | twenty-two | [sound:ic_jp_twenty-two.mp3]
さんじゅうさん | san-jū san | thirty-three | [sound:ic_jp_thirty-three.mp3]
よんじゅうよん | yon-jū yon | forty-four | [sound:ic_jp_forty-four.mp3]
ごじゅうご | go-jū go | fifty-five | [sound:ic_jp_fifty-five.mp3]
ろくじゅうろく | roku-jū roku | sixty-six | [sound:ic_jp_sixty-six.mp3]
ななじゅうなな | nana-jū nana | seventy-seven | [sound:ic_jp_seventy-seven.mp3]
はちじゅうはち | hachi-jū hachi | eighty-eight | [sound:ic_jp_eighty-eight.mp3]
きゅうじゅうきゅう | kyū-jū kyū | ninety-nine | [sound:ic_jp_ninety-nine.mp3]
ひゃく | hyaku | one hundred | [sound:ic_jp_one-hundred.mp3]
せん | sen | one thousand | [sound:ic_jp_one-thousand.mp3]
にせん | ni-sen | two thousand | [sound:ic_jp_two-thousand.mp3]
はっせん | ha-ssen | eight thousand | [sound:ic_jp_eight-thousand.mp3]
いちまん | ichi-man | ten thousand | [sound:ic_jp_ten-thousand.mp3]
よんせん | yon-sen | four thousand | [sound:ic_jp_four-thousand.mp3]
ごせん | go-sen | five thousand | [sound:ic_jp_five-thousand.mp3]
さんぜん | san-zen | three thousand | [sound:ic_jp_three-thousand.mp3]
ろくせん | roku-sen | six thousand | [sound:ic_jp_six-thousand.mp3]
ななせん | nana-sen | seven thousand | [sound:ic_jp_seven-thousand.mp3]
きゅうせん | kyū-sen | nine thousand | [sound:ic_jp_nine-thousand.mp3]
じゅうおく | jū-oku | one billion | [sound:ic_jp_one-billion.mp3]
いっちょう | i-cchō | one trillion | [sound:ic_jp_one-trillion.mp3]
じゅうまん | jū-man | one hundred thousand | [sound:ic_jp_one-hundred-thousand.mp3]
ひゃくまん | hyaku-man | one million | [sound:ic_jp_one-million.mp3]
せんおく | sen-oku | one hundred billion | [sound:ic_jp_one-hundred-billion.mp3]
ひゃくおく | hyaku-oku | ten billion | [sound:ic_jp_ten-billion.mp3]
いちおく | ichi-oku | one hundred million | [sound:ic_jp_one-hundred-million.mp3]
ひゃくちょう | hyaku-chō | one hundred trillion | [sound:ic_jp_one-hundred-trillion.mp3]
じゅうちょう | ju-cchō | ten trillion | [sound:ic_jp_ten-trillion.mp3]
いちばん | ichi-ban | first | [sound:ic_jp_first.mp3]
にばん | ni-ban | second | [sound:ic_jp_second.mp3]
さんばん | san-ban | third | [sound:ic_jp_third.mp3]
よんばん | yon-ban | fourth | [sound:ic_jp_fourth.mp3]
ごばん | go-ban | fifth | [sound:ic_jp_fifth.mp3]
ろくばん | roku-ban | sixth | [sound:ic_jp_sixth.mp3]
ななばん | nana-ban | seventh | [sound:ic_jp_seventh.mp3]
きゅうばん | kyū-ban | ninth | [sound:ic_jp_ninth.mp3]
じゅうばん | jū-ban | tenth | [sound:ic_jp_tenth.mp3]
はちばん | hachi-ban | eighth | [sound:ic_jp_eighth.mp3]
チェックの | chekku no | checkered | [sound:ic_jp_checkered.mp3]
みずたま | mizutama | polka dot | [sound:ic_jp_polka-dot.mp3]
ピンストライプの | pinsutoraipu no | pin-striped | [sound:ic_jp_pin-striped.mp3]
てん | ten | dot | [sound:ic_jp_dot.mp3]
むじ | muji | solid | [sound:ic_jp_solid.mp3]
しまもようの | shima moyō no | striped | [sound:ic_jp_striped.mp3]
こうしがら | kōshigara | plaid | [sound:ic_jp_plaid.mp3]
ウェーブした | wēbu shita | wavy | [sound:ic_jp_wavy.mp3]
かぎ | kagi | key | [sound:ic_jp_key.mp3]
うんてんめんきょしょう | unten menkyoshō | driver's license | [sound:ic_jp_driver's-license.mp3]
さいふ | saifu | wallet | [sound:ic_jp_wallet.mp3]
ハンドバッグ | handobaggu | purse | [sound:ic_jp_purse.mp3]
みぶんしょうめいしょ | mibun shōmeisho | identification | [sound:ic_jp_identification.mp3]
なぜ | naze | why | [sound:ic_jp_why.mp3]
どう | dō | how | [sound:ic_jp_how.mp3]
いつ | itsu | when | [sound:ic_jp_when.mp3]
どこ | doko | where | [sound:ic_jp_where.mp3]
なに | nani | what | [sound:ic_jp_what.mp3]
だれ | dare | who | [sound:ic_jp_who.mp3]
どんな | donna | what kind | [sound:ic_jp_what-kind.mp3]
ちょうしはどうですか。 | Chōshi wa dō desu ka? | What's up? | [sound:ic_jp_What's-up?.mp3]
おなまえは? | O-namae wa? | What's your name? | [sound:ic_jp_What's-your-name?.mp3]
でんわばんごうはなんばんですか？ | Denwa bangō wa nan-ban desu ka? | What's your phone number? | [sound:ic_jp_What's-your-phone-number?.mp3]
メールアドレスはなんですか？ | Mēruadoresu wa nan desu ka? | What's your e-mail address? | [sound:ic_jp_What's-your-e-mail-address?.mp3]
おいくつですか。 | O-ikutsu desu ka. | How old are you? | [sound:ic_jp_How-old-are-you?.mp3]
ごしゅっしんはどちらですか。 | Go-shusshin wa dochira desu ka. | Where are you from? | [sound:ic_jp_Where-are-you-from?.mp3]
どこにすんでいますか。 | Doko ni sunde imasu ka. | Where do you live? | [sound:ic_jp_Where-do-you-live?.mp3]
あれはだれですか？ | Are wa dare desu ka? | Who is that? | [sound:ic_jp_Who-is-that?.mp3]
それはなんですか。 | Sore wa nan desu ka. | What is it? | [sound:ic_jp_What-is-it?.mp3]
どこにすんでいますか？ | Doko ni sunde imasu ka? | Where do you live? | [sound:ic_jp_Where-do-you-live?.mp3]
なにそれ。 | Nani sore. | What's that? | [sound:ic_jp_What's-that?.mp3]
だれですか。 | Dare desu ka. | Who is it? | [sound:ic_jp_Who-is-it?.mp3]
まるい | marui | round | [sound:ic_jp_round.mp3]
おおきい | ōkii | big | [sound:ic_jp_big.mp3]
みっしゅうした | misshū shita | dense | [sound:ic_jp_dense.mp3]
こうだい | kōdai | vast | [sound:ic_jp_vast.mp3]
しかくい | shikakui | square | [sound:ic_jp_square.mp3]
あらい | arai | coarse | [sound:ic_jp_coarse.mp3]
なめらか | nameraka | fine | [sound:ic_jp_fine.mp3]
おもい | omoi | heavy | [sound:ic_jp_heavy.mp3]
ながい | nagai | long | [sound:ic_jp_long.mp3]
りっぽうたい | rippōtai | cube | [sound:ic_jp_cube.mp3]
レシート | reshīto | receipt | [sound:ic_jp_receipt.mp3]
プレゼント | purezento | present | [sound:ic_jp_present.mp3]
きゃく | kyaku | customer | [sound:ic_jp_customer.mp3]
かえす | kaesu | return | [sound:ic_jp_return.mp3]
かう | kau | buy | [sound:ic_jp_buy.mp3]
だいきん | daikin | cost | [sound:ic_jp_cost.mp3]
わりびき | waribiki | discount | [sound:ic_jp_discount.mp3]
セール | sēru | sale | [sound:ic_jp_sale.mp3]
はんばいいん | hanbai-in | salesperson | [sound:ic_jp_salesperson.mp3]
げんきん | genkin | cash | [sound:ic_jp_cash.mp3]
おかねをつかう | o-kane o tsukau | spend money | [sound:ic_jp_spend-money.mp3]
ようふくや | yōfuku-ya | clothing store | [sound:ic_jp_clothing-store.mp3]
デパート | depāto | department store | [sound:ic_jp_department-store.mp3]
ブティック | butikku | boutique | [sound:ic_jp_boutique.mp3]
くつや | kutsu-ya | shoe store | [sound:ic_jp_shoe-store.mp3]
ほうしょくてん | hōshokuten | jewelry store | [sound:ic_jp_jewelry-store.mp3]
ショッピングモール | shoppingmōru | mall | [sound:ic_jp_mall.mp3]
スーパーマーケット | sūpāmāketto | supermarket | [sound:ic_jp_supermarket.mp3]
サンプル | sanpuru | sample | [sound:ic_jp_sample.mp3]
かいもの | kaimono | shopping | [sound:ic_jp_shopping.mp3]
みせ | mise | store | [sound:ic_jp_store.mp3]
いちば | ichiba | market | [sound:ic_jp_market.mp3]
ねだん | nedan | price | [sound:ic_jp_price.mp3]
クーポンけん | kūpon ken | coupon | [sound:ic_jp_coupon.mp3]
つうろ | tsūro | aisle | [sound:ic_jp_aisle.mp3]
カバン | kaban | bag | [sound:ic_jp_bag.mp3]
かいものカート | kaimono kāto | shopping cart | [sound:ic_jp_shopping-cart.mp3]
ビニールぶくろ | binīru bukuro | plastic bag | [sound:ic_jp_plastic-bag.mp3]
コンピューター | konpyūtā | computer | [sound:ic_jp_computer.mp3]
ノートパソコン | nōtopasokon | laptop | [sound:ic_jp_laptop.mp3]
けいたいメールをする | keitai mēru o suru | text | [sound:ic_jp_text.mp3]
インターネットカフェ | intānetto kafe | Internet cafe | [sound:ic_jp_Internet-cafe.mp3]
ワイファイ | waifai | Wi-Fi | [sound:ic_jp_Wi-Fi.mp3]
むせん | musen | wireless | [sound:ic_jp_wireless.mp3]
メール | mēru | e-mail | [sound:ic_jp_e-mail.mp3]
けいたいメール | keitai mēru | text message | [sound:ic_jp_text-message.mp3]
スカイプ | Sukaipu | Skype | [sound:ic_jp_Skype.mp3]
ヤフー | Yafū | Yahoo! | [sound:ic_jp_Yahoo!.mp3]
アイフォン | Aifon | iPhone | [sound:ic_jp_iPhone.mp3]
ブログ | burogu | blog | [sound:ic_jp_blog.mp3]
ソーシャルネットワーキングサイト | sōsharu　nettowākingu saito | social networking site | [sound:ic_jp_social-networking-site.mp3]
ホットメール | Hottomēru | Hotmail | [sound:ic_jp_Hotmail.mp3]
けんさくエンジン | kensaku enjin | search engine | [sound:ic_jp_search-engine.mp3]
インターネットせつぞく | intānetto setsuzoku | Internet access | [sound:ic_jp_Internet-access.mp3]
じゅわき | juwaki | receiver | [sound:ic_jp_receiver.mp3]
ファックス | fakkusu | fax | [sound:ic_jp_fax.mp3]
こうしゅうでんわ | kōshū denwa | public phone | [sound:ic_jp_public-phone.mp3]
はなしちゅう | hanashi chū | busy | [sound:ic_jp_busy.mp3]
アイピーでんわ | aipī denwa | IP phone | [sound:ic_jp_IP-phone.mp3]
けいたいでんわ | keitaidenwa | cellular phone | [sound:ic_jp_cellular-phone.mp3]
けいたいでんわ | keitaidenwa | mobile phone | [sound:ic_jp_mobile-phone.mp3]
けいたいでんわ | keitai denwa | cellular phone | [sound:ic_jp_cellular-phone.mp3]
けいたいでんわ | keitai denwa | mobile phone | [sound:ic_jp_mobile-phone.mp3]
しないでんわ | shinai denwa | local phone call | [sound:ic_jp_local-phone-call.mp3]
まちがいでんわをかける | machigai denwa o kakeru | call a wrong number | [sound:ic_jp_call-a-wrong-number.mp3]
でんわをかける | denwa o kakeru | dial | [sound:ic_jp_dial.mp3]
でんわにでる | denwa ni deru | pick up | [sound:ic_jp_pick-up.mp3]
でんわばんごう | denwa bangō | phone number | [sound:ic_jp_phone-number.mp3]
オペレーター | operētā | operator | [sound:ic_jp_operator.mp3]
ちょうきょりでんわ | chōkyori denwa | long-distance call | [sound:ic_jp_long-distance-call.mp3]
よる | yoru | evening | [sound:ic_jp_evening.mp3]
あさ | asa | morning | [sound:ic_jp_morning.mp3]
いちにちじゅう | ichi-nichi-jū | all day | [sound:ic_jp_all-day.mp3]
よる | yoru | nighttime | [sound:ic_jp_nighttime.mp3]
にっちゅう | nicchū | daytime | [sound:ic_jp_daytime.mp3]
のあと | ~ no ato | after | [sound:ic_jp_after.mp3]
これから | korekara | from now on | [sound:ic_jp_from-now-on.mp3]
まえに | mae ni | before | [sound:ic_jp_before.mp3]
ぜんぜん～ない | zenzen~nai | never | [sound:ic_jp_never.mp3]
いま | ima | now | [sound:ic_jp_now.mp3]
よく | yoku | often | [sound:ic_jp_often.mp3]
ふだん | fudan | usually | [sound:ic_jp_usually.mp3]
ふゆ | fuyu | winter | [sound:ic_jp_winter.mp3]
なつ | natsu | summer | [sound:ic_jp_summer.mp3]
はる | haru | spring | [sound:ic_jp_spring.mp3]
あき | aki | fall | [sound:ic_jp_fall.mp3]
あめ | ame | rain | [sound:ic_jp_rain.mp3]
ゆき | yuki | snow | [sound:ic_jp_snow.mp3]
くも | kumo | cloud | [sound:ic_jp_cloud.mp3]
ごうう | gōu | heavy rain | [sound:ic_jp_heavy-rain.mp3]
こおる | kōru | freeze | [sound:ic_jp_freeze.mp3]
こうずい | kōzui | flood | [sound:ic_jp_flood.mp3]
たいふう | taifū | typhoon | [sound:ic_jp_typhoon.mp3]
てんきよほう | tenki yohō | weather report | [sound:ic_jp_weather-report.mp3]
はれた | hareta | sunny | [sound:ic_jp_sunny.mp3]
あめの | ame no | rainy | [sound:ic_jp_rainy.mp3]
にじ | niji | rainbow | [sound:ic_jp_rainbow.mp3]
いなずま | inazuma | lightning | [sound:ic_jp_lightning.mp3]
せっし | sesshi | Celsius | [sound:ic_jp_Celsius.mp3]
かし | kashi | Fahrenheit | [sound:ic_jp_Fahrenheit.mp3]
かいせい | kaisei | clear sky | [sound:ic_jp_clear-sky.mp3]
にわかあめ | niwaka ame | shower | [sound:ic_jp_shower.mp3]
きりさめ | kirisame | drizzle | [sound:ic_jp_drizzle.mp3]
おんど | ondo | temperature | [sound:ic_jp_temperature.mp3]
しめった | shimetta | humid | [sound:ic_jp_humid.mp3]
しっけ | shikke | humidity | [sound:ic_jp_humidity.mp3]
かぜ | kaze | wind | [sound:ic_jp_wind.mp3]
かぜのつよい | kaze no tsuyoi | windy | [sound:ic_jp_windy.mp3]
みぞれ | mizore | sleet | [sound:ic_jp_sleet.mp3]
こおりがはる | kōri ga haru | ice over | [sound:ic_jp_ice-over.mp3]
かみなり | kaminari | thunder | [sound:ic_jp_thunder.mp3]
むしむしした | mushimushi shita | muggy | [sound:ic_jp_muggy.mp3]
きり | kiri | fog | [sound:ic_jp_fog.mp3]
らいう | raiu | thunderstorm | [sound:ic_jp_thunderstorm.mp3]
ハリケーン | harikēn | hurricane | [sound:ic_jp_hurricane.mp3]
たつまき | tatsumaki | tornado | [sound:ic_jp_tornado.mp3]
くもった | kumotta | cloudy | [sound:ic_jp_cloudy.mp3]
ひょうてんか | hyōtenka | below freezing | [sound:ic_jp_below-freezing.mp3]
ふうそくれいきゃく | fūsoku reikyaku | wind chill | [sound:ic_jp_wind-chill.mp3]
れいか | reika | below zero | [sound:ic_jp_below-zero.mp3]
はれる | hareru | clear up | [sound:ic_jp_clear-up.mp3]
もうしょ | mōsho | extreme heat | [sound:ic_jp_extreme-heat.mp3]
しも | shimo | frost | [sound:ic_jp_frost.mp3]
くもる | kumoru | become cloudy | [sound:ic_jp_become-cloudy.mp3]
こおり | kōri | ice | [sound:ic_jp_ice.mp3]
ひょう | hyō | hail | [sound:ic_jp_hail.mp3]
サイクロン | saikuron | cyclone | [sound:ic_jp_cyclone.mp3]
サイクロン | saikuron | cyclone | [sound:ic_jp_cyclone.mp3]
え | e | painting | [sound:ic_jp_painting.mp3]
びじゅつ | bijutsu | art | [sound:ic_jp_art.mp3]
え | e | drawing | [sound:ic_jp_drawing.mp3]
ちょうこく | chōkoku | sculpture | [sound:ic_jp_sculpture.mp3]
コメディー | komedī | comedy | [sound:ic_jp_comedy.mp3]
ほん | hon | book | [sound:ic_jp_book.mp3]
ぶんがく | bungaku | literature | [sound:ic_jp_literature.mp3]
たんぺんしょうせつ | tanpen shōsetsu | short story | [sound:ic_jp_short-story.mp3]
さっか | sakka | writer | [sound:ic_jp_writer.mp3]
さっか | sakka | author | [sound:ic_jp_author.mp3]
さっか | sakka | writer | [sound:ic_jp_writer.mp3]
さっか | sakka | author | [sound:ic_jp_author.mp3]
えいが | eiga | movie | [sound:ic_jp_movie.mp3]
はいゆう | haiyū | actor | [sound:ic_jp_actor.mp3]
じょゆう | joyū | actress | [sound:ic_jp_actress.mp3]
かんとく | kantoku | director | [sound:ic_jp_director.mp3]
ものがたり | monogatari | story | [sound:ic_jp_story.mp3]
あらすじ | arasuji | plot | [sound:ic_jp_plot.mp3]
ポップス | poppusu | pop music | [sound:ic_jp_pop-music.mp3]
かしゅ | kashu | singer | [sound:ic_jp_singer.mp3]
かしゅ | kashu | singer | [sound:ic_jp_singer.mp3]
おんがく | ongaku | music | [sound:ic_jp_music.mp3]
がっき | gakki | musical instrument | [sound:ic_jp_musical-instrument.mp3]
オペラ | opera | opera | [sound:ic_jp_opera.mp3]
ジャズ | jazu | jazz | [sound:ic_jp_jazz.mp3]
ロック | rokku | rock 'n' roll | [sound:ic_jp_rock-'n'-roll.mp3]
クラッシックおんがく | kurasshikku ongaku | classical music | [sound:ic_jp_classical-music.mp3]
ラップ | rappu | rap music | [sound:ic_jp_rap-music.mp3]
バンド | bando | band | [sound:ic_jp_band.mp3]
ギター | gitā | guitar | [sound:ic_jp_guitar.mp3]
トランペット | toranpetto | trumpet | [sound:ic_jp_trumpet.mp3]
バイオリン | baiorin | violin | [sound:ic_jp_violin.mp3]
ピアノ | piano | piano | [sound:ic_jp_piano.mp3]
フルート | furūto | flute | [sound:ic_jp_flute.mp3]
トロンボーン | toronbōn | trombone | [sound:ic_jp_trombone.mp3]
サクソフォン | sakusofon | saxophone | [sound:ic_jp_saxophone.mp3]
ドラム | doramu | drums | [sound:ic_jp_drums.mp3]
ハーモニカ | hāmonika | harmonica | [sound:ic_jp_harmonica.mp3]
キーボード | kībōdo | keyboard | [sound:ic_jp_keyboard.mp3]
げきじょう | gekijō | theater | [sound:ic_jp_theater.mp3]
ミュージカル | myūjikaru | musical | [sound:ic_jp_musical.mp3]
しゃしん | shashin | photo | [sound:ic_jp_photo.mp3]
しゃしん | shashin | photograph | [sound:ic_jp_photograph.mp3]
しゃしん | shashin | photo | [sound:ic_jp_photo.mp3]
しゃしん | shashin | photograph | [sound:ic_jp_photograph.mp3]
しゃしんさつえい | shashin satsuei | photography | [sound:ic_jp_photography.mp3]
カメラ | kamera | camera | [sound:ic_jp_camera.mp3]
たのしむ | tanoshimu | enjoy | [sound:ic_jp_enjoy.mp3]
おなかがすく | o-naka ga suku | hungry | [sound:ic_jp_hungry.mp3]
のどがかわく | nodo ga kawaku | thirsty | [sound:ic_jp_thirsty.mp3]
ちょうみりょう | chōmiryō | condiment | [sound:ic_jp_condiment.mp3]
にんにく | ninniku | garlic | [sound:ic_jp_garlic.mp3]
さとう | satō | sugar | [sound:ic_jp_sugar.mp3]
しお | shio | salt | [sound:ic_jp_salt.mp3]
す | su | vinegar | [sound:ic_jp_vinegar.mp3]
とうがらし | tōgarashi | chili pepper | [sound:ic_jp_chili-pepper.mp3]
バター | batā | butter | [sound:ic_jp_butter.mp3]
ホットソース | hotto sōsu | hot sauce | [sound:ic_jp_hot-sauce.mp3]
ケチャップ | kechappu | ketchup | [sound:ic_jp_ketchup.mp3]
マスタード | masutādo | mustard | [sound:ic_jp_mustard.mp3]
タバスコ | tabasuko | Tabasco sauce | [sound:ic_jp_Tabasco-sauce.mp3]
こしょう | koshō | pepper | [sound:ic_jp_pepper.mp3]
こめ | kome | rice | [sound:ic_jp_rice.mp3]
パン | pan | bread | [sound:ic_jp_bread.mp3]
やさい | yasai | vegetable | [sound:ic_jp_vegetable.mp3]
ぎょかいるい | gyokai-rui | seafood | [sound:ic_jp_seafood.mp3]
さかな | sakana | fish | [sound:ic_jp_fish.mp3]
ぎゅうにく | gyū niku | beef | [sound:ic_jp_beef.mp3]
ぶたにく | buta niku | pork | [sound:ic_jp_pork.mp3]
とりにく | tori niku | chicken | [sound:ic_jp_chicken.mp3]
ラムにく | ramu niku | lamb | [sound:ic_jp_lamb.mp3]
ケーキ | kēki | cake | [sound:ic_jp_cake.mp3]
たまご | tamago | egg | [sound:ic_jp_egg.mp3]
だす | dasu | serve | [sound:ic_jp_serve.mp3]
まぜる | mazeru | mix | [sound:ic_jp_mix.mp3]
きざむ | kizamu | chop | [sound:ic_jp_chop.mp3]
ひく | hiku | mince | [sound:ic_jp_mince.mp3]
やく | yaku | bake | [sound:ic_jp_bake.mp3]
あみでやく | ami de yaku | grill | [sound:ic_jp_grill.mp3]
よういする | yōi suru | prepare | [sound:ic_jp_prepare.mp3]
いためる | itameru | stir-fry | [sound:ic_jp_stir-fry.mp3]
やく | yaku | fry | [sound:ic_jp_fry.mp3]
あぶる | aburu | roast | [sound:ic_jp_roast.mp3]
きる | kiru | cut | [sound:ic_jp_cut.mp3]
ソテーする | sotē suru | sauté | [sound:ic_jp_sauté.mp3]
ゆでる | yuderu | boil | [sound:ic_jp_boil.mp3]
むす | musu | steam | [sound:ic_jp_steam.mp3]
あたためなおす | atatame naosu | reheat | [sound:ic_jp_reheat.mp3]
でんしれんじにかける | denshirenji ni kakeru | microwave | [sound:ic_jp_microwave.mp3]
バーベキューする | bābekyū suru | barbecue | [sound:ic_jp_barbecue.mp3]
コーヒー | kōhī | coffee | [sound:ic_jp_coffee.mp3]
ビール | bīru | beer | [sound:ic_jp_beer.mp3]
ウィスキー | wisukī | whiskey | [sound:ic_jp_whiskey.mp3]
ふっとうしているおゆ | futtō shite iru o-yu | boiling water | [sound:ic_jp_boiling-water.mp3]
フルーツジュース | furūtsu jūsu | fruit juice | [sound:ic_jp_fruit-juice.mp3]
たんさんいんりょう | tansan inryō | soda | [sound:ic_jp_soda.mp3]
たんさんいんりょう | tansan inryō | pop | [sound:ic_jp_pop.mp3]
たんさんいんりょう | tansan inryō | soda | [sound:ic_jp_soda.mp3]
たんさんいんりょう | tansan inryō | pop | [sound:ic_jp_pop.mp3]
ぎゅうにゅう | gyūnyū | milk | [sound:ic_jp_milk.mp3]
こおり | kōri | ice | [sound:ic_jp_ice.mp3]
こうちゃ | kōcha | black tea | [sound:ic_jp_black-tea.mp3]
ハーブティー | hābu tī | herb tea | [sound:ic_jp_herb-tea.mp3]
ちゃ | cha | tea | [sound:ic_jp_tea.mp3]
カフェラテ | kafe rate | caffe latte | [sound:ic_jp_caffe-latte.mp3]
ワイン | wain | wine | [sound:ic_jp_wine.mp3]
ココア | kokoa | cocoa | [sound:ic_jp_cocoa.mp3]
ソフトドリンク | sofuto dorinku | soft drink | [sound:ic_jp_soft-drink.mp3]
ジュース | jūsu | juice | [sound:ic_jp_juice.mp3]
みず | mizu | water | [sound:ic_jp_water.mp3]
アルコール | arukōru | alcohol | [sound:ic_jp_alcohol.mp3]
はし | hashi | chopsticks | [sound:ic_jp_chopsticks.mp3]
しょっき | shokki | eating utensil | [sound:ic_jp_eating-utensil.mp3]
スプーン | supūn | spoon | [sound:ic_jp_spoon.mp3]
フォーク | fōku | fork | [sound:ic_jp_fork.mp3]
ナイフ | naifu | knife | [sound:ic_jp_knife.mp3]
ステーキナイフ | sutēki naifu | steak knife | [sound:ic_jp_steak-knife.mp3]
にくぎりぼうちょう | niku giri bōchō | carving knife | [sound:ic_jp_carving-knife.mp3]
トング | tongu | tongs | [sound:ic_jp_tongs.mp3]
ハンバーガー | hanbāgā | hamburger | [sound:ic_jp_hamburger.mp3]
チーズバーガー | chīzubāgā | cheeseburger | [sound:ic_jp_cheeseburger.mp3]
ピザ | piza | pizza | [sound:ic_jp_pizza.mp3]
ホットドッグ | hotto doggu | hot dog | [sound:ic_jp_hot-dog.mp3]
しおからい | shiokarai | salty | [sound:ic_jp_salty.mp3]
あじ | aji | taste | [sound:ic_jp_taste.mp3]
あまい | amai | sweet | [sound:ic_jp_sweet.mp3]
にがい | nigai | bitter | [sound:ic_jp_bitter.mp3]
からい | karai | spicy | [sound:ic_jp_spicy.mp3]
すっぱい | suppai | sour | [sound:ic_jp_sour.mp3]
あじみする | ajimi suru | taste | [sound:ic_jp_taste.mp3]
むぎ | mugi | wheat | [sound:ic_jp_wheat.mp3]
ごはん | go-han | cooked rice | [sound:ic_jp_cooked-rice.mp3]
おおむぎ | ōmugi | barley | [sound:ic_jp_barley.mp3]
にく | niku | meat | [sound:ic_jp_meat.mp3]
おかし | o-kashi | sweets | [sound:ic_jp_sweets.mp3]
キャンディー | kyandī | candy | [sound:ic_jp_candy.mp3]
めん | men | noodle | [sound:ic_jp_noodle.mp3]
くだもの | kudamono | fruit | [sound:ic_jp_fruit.mp3]
あんず | anzu | apricot | [sound:ic_jp_apricot.mp3]
バナナ | banana | banana | [sound:ic_jp_banana.mp3]
りんご | ringo | apple | [sound:ic_jp_apple.mp3]
ぶどう | budō | grape | [sound:ic_jp_grape.mp3]
スイカ | suika | watermelon | [sound:ic_jp_watermelon.mp3]
グレープフルーツ | gurēpufurūtsu | grapefruit | [sound:ic_jp_grapefruit.mp3]
パイナップル | painappuru | pineapple | [sound:ic_jp_pineapple.mp3]
メロン | meron | melon | [sound:ic_jp_melon.mp3]
トマト | tomato | tomato | [sound:ic_jp_tomato.mp3]
いちご | ichigo | strawberry | [sound:ic_jp_strawberry.mp3]
イチジク | ichijiku | fig | [sound:ic_jp_fig.mp3]
プラム | puramu | plum | [sound:ic_jp_plum.mp3]
サクランボ | sakuranbo | cherry | [sound:ic_jp_cherry.mp3]
ブルーベリー | burūberī | blueberry | [sound:ic_jp_blueberry.mp3]
プルーン | purūn | prune | [sound:ic_jp_prune.mp3]
マンゴー | mangō | mango | [sound:ic_jp_mango.mp3]
もも | momo | peach | [sound:ic_jp_peach.mp3]
レモン | remon | lemon | [sound:ic_jp_lemon.mp3]
ラズベリー | razuberī | raspberry | [sound:ic_jp_raspberry.mp3]
クランベリー | kuranberī | cranberry | [sound:ic_jp_cranberry.mp3]
オレンジ | orenji | orange | [sound:ic_jp_orange.mp3]
しょうが | shōga | ginger | [sound:ic_jp_ginger.mp3]
オリーブオイル | orību oiru | olive oil | [sound:ic_jp_olive-oil.mp3]
スパイス | supaisu | spice | [sound:ic_jp_spice.mp3]
ソース | sōsu | sauce | [sound:ic_jp_sauce.mp3]
サラダあぶら | sarada abura | vegetable oil | [sound:ic_jp_vegetable-oil.mp3]
ごまあぶら | goma abura | sesame oil | [sound:ic_jp_sesame-oil.mp3]
ざいりょう | zairyō | ingredient | [sound:ic_jp_ingredient.mp3]
こむぎこ | komugiko | flour | [sound:ic_jp_flour.mp3]
しょくようあぶら | shokuyō abura | cooking oil | [sound:ic_jp_cooking-oil.mp3]
ちゅうしょく | chūshoku | lunch | [sound:ic_jp_lunch.mp3]
ゆうしょく | yūshoku | dinner | [sound:ic_jp_dinner.mp3]
ぜんさい | zensai | appetizer | [sound:ic_jp_appetizer.mp3]
アントレ | antore | entrée | [sound:ic_jp_entrée.mp3]
アントレ | antore | main course | [sound:ic_jp_main-course.mp3]
メインりょうり | mein ryōri | entrée | [sound:ic_jp_entrée.mp3]
メインりょうり | mein ryōri | main course | [sound:ic_jp_main-course.mp3]
かていりょうり | katei ryōri | home cooking | [sound:ic_jp_home-cooking.mp3]
おかし | o-kashi | snack | [sound:ic_jp_snack.mp3]
やしょく | yashoku | midnight snack | [sound:ic_jp_midnight-snack.mp3]
おなかがいっぱい | o-naka ga ippai | full | [sound:ic_jp_full.mp3]
デザート | dezāto | dessert | [sound:ic_jp_dessert.mp3]
コースりょうり | kōsu ryōri | course meal | [sound:ic_jp_course-meal.mp3]
ビュッフェ | byuffe | buffet | [sound:ic_jp_buffet.mp3]
たべほうだい | tabehōdai | all-you-can-eat | [sound:ic_jp_all-you-can-eat.mp3]
しょくじ | shokuji | meal | [sound:ic_jp_meal.mp3]
ナッツ | nattsu | nut | [sound:ic_jp_nut.mp3]
ピーナッツ | pīnattsu | peanut | [sound:ic_jp_peanut.mp3]
カシューナッツ | kashūnattsu | cashew nut | [sound:ic_jp_cashew-nut.mp3]
チップ | chippu | tip | [sound:ic_jp_tip.mp3]
ウェイトレス | weitoresu | waitress | [sound:ic_jp_waitress.mp3]
ウェイター | weitā | waiter | [sound:ic_jp_waiter.mp3]
せっきゃくしゅにん | sekkyaku shunin | maitre d' | [sound:ic_jp_maitre-d'.mp3]
シェフ | shefu | chef | [sound:ic_jp_chef.mp3]
メニュー | menyū | menu | [sound:ic_jp_menu.mp3]
セルフサービス | serufu sābisu | self-service | [sound:ic_jp_self-service.mp3]
ピッチャーのみず | pitchā no mizu | pitcher of water | [sound:ic_jp_pitcher-of-water.mp3]
きんえん | kin'en | non-smoking | [sound:ic_jp_non-smoking.mp3]
きつえん | kitsuen | smoking | [sound:ic_jp_smoking.mp3]
せいきゅうしょ | seikyūsho | bill | [sound:ic_jp_bill.mp3]
りょうりをちゅうもんする | ryōri o chūmon suru | order food | [sound:ic_jp_order-food.mp3]
ファーストフード | fāsuto fūdo | fast food | [sound:ic_jp_fast-food.mp3]
ようしょく | yōshoku | Western food | [sound:ic_jp_Western-food.mp3]
イタリアりょうり | Itaria ryōri | Italian food | [sound:ic_jp_Italian-food.mp3]
ちゅうかりょうり | Chūka ryōri | Chinese food | [sound:ic_jp_Chinese-food.mp3]
エスニックりょうり | esunikku ryōri | ethnic food | [sound:ic_jp_ethnic-food.mp3]
レストラン | resutoran | restaurant | [sound:ic_jp_restaurant.mp3]
カフェ | kafe | café | [sound:ic_jp_café.mp3]
カフェ | kafe | coffee shop | [sound:ic_jp_coffee-shop.mp3]
コーヒーショップ | kōhī shoppu | café | [sound:ic_jp_café.mp3]
コーヒーショップ | kōhī shoppu | coffee shop | [sound:ic_jp_coffee-shop.mp3]
バー | bā | bar | [sound:ic_jp_bar.mp3]
エビ | ebi | shrimp | [sound:ic_jp_shrimp.mp3]
さけ | sake | salmon | [sound:ic_jp_salmon.mp3]
マグロ | maguro | tuna | [sound:ic_jp_tuna.mp3]
カニ | kani | crab | [sound:ic_jp_crab.mp3]
ロブスター | robusutā | lobster | [sound:ic_jp_lobster.mp3]
おたま | otama | ladle | [sound:ic_jp_ladle.mp3]
つまようじ | tsumayōji | toothpick | [sound:ic_jp_toothpick.mp3]
さら | sara | dish | [sound:ic_jp_dish.mp3]
さら | sara | plate | [sound:ic_jp_plate.mp3]
カップ | kappu | cup | [sound:ic_jp_cup.mp3]
コップ | koppu | drinking glass | [sound:ic_jp_drinking-glass.mp3]
コーヒーマグ | kōhī magu | coffee mug | [sound:ic_jp_coffee-mug.mp3]
ティーカップ | tīkappu | teacup | [sound:ic_jp_teacup.mp3]
ピッチャー | picchā | pitcher | [sound:ic_jp_pitcher.mp3]
ティーポット | tīpotto | teapot | [sound:ic_jp_teapot.mp3]
ワイングラス | wain gurasu | wine glass | [sound:ic_jp_wine-glass.mp3]
コーヒーポット | kōhīpotto | coffee pot | [sound:ic_jp_coffee-pot.mp3]
トウモロコシ | tōmorokoshi | corn | [sound:ic_jp_corn.mp3]
ジャガイモ | jagaimo | potato | [sound:ic_jp_potato.mp3]
だいず | daizu | soybean | [sound:ic_jp_soybean.mp3]
サツマイモ | satsumaimo | sweet potato | [sound:ic_jp_sweet-potato.mp3]
にんじん | ninjin | carrot | [sound:ic_jp_carrot.mp3]
かぶ | kabu | turnip | [sound:ic_jp_turnip.mp3]
たまねぎ | tamanegi | onion | [sound:ic_jp_onion.mp3]
キノコ | kinoko | mushroom | [sound:ic_jp_mushroom.mp3]
レタス | retasu | lettuce | [sound:ic_jp_lettuce.mp3]
キュウリ | kyūri | cucumber | [sound:ic_jp_cucumber.mp3]
カリフラワー | karifurawā | cauliflower | [sound:ic_jp_cauliflower.mp3]
キャベツ | kyabetsu | cabbage | [sound:ic_jp_cabbage.mp3]
セロリ | serori | celery | [sound:ic_jp_celery.mp3]
なす | nasu | eggplant | [sound:ic_jp_eggplant.mp3]
ピーマン | pīman | bell pepper | [sound:ic_jp_bell-pepper.mp3]
ブロッコリー | burokkorī | broccoli | [sound:ic_jp_broccoli.mp3]
ほうれんそう | hōrensō | spinach | [sound:ic_jp_spinach.mp3]
モヤシ | moyashi | bean sprout | [sound:ic_jp_bean-sprout.mp3]
あし | ashi | foot | [sound:ic_jp_foot.mp3]
あしくび | ashikubi | ankle | [sound:ic_jp_ankle.mp3]
あし | ashi | leg | [sound:ic_jp_leg.mp3]
あたま | atama | head | [sound:ic_jp_head.mp3]
くび | kubi | neck | [sound:ic_jp_neck.mp3]
うで | ude | arm | [sound:ic_jp_arm.mp3]
ひじ | hiji | elbow | [sound:ic_jp_elbow.mp3]
てくび | tekubi | wrist | [sound:ic_jp_wrist.mp3]
て | te | hand | [sound:ic_jp_hand.mp3]
ゆび | yubi | finger | [sound:ic_jp_finger.mp3]
きんにく | kinniku | muscle | [sound:ic_jp_muscle.mp3]
ほね | hone | bone | [sound:ic_jp_bone.mp3]
せぼね | sebone | backbone | [sound:ic_jp_backbone.mp3]
からだ | karada | body | [sound:ic_jp_body.mp3]
い | i | stomach | [sound:ic_jp_stomach.mp3]
ひざ | hiza | knee | [sound:ic_jp_knee.mp3]
はだ | hada | skin | [sound:ic_jp_skin.mp3]
けつえき | ketsueki | blood | [sound:ic_jp_blood.mp3]
せなか | senaka | back | [sound:ic_jp_back.mp3]
むね | mune | chest | [sound:ic_jp_chest.mp3]
ひく | hiku | pull | [sound:ic_jp_pull.mp3]
しゃがむ | shagamu | squat | [sound:ic_jp_squat.mp3]
みぶりてぶりではなす | miburi teburi de hanasu | gesture | [sound:ic_jp_gesture.mp3]
てをあげる | te o ageru | raise one's hand | [sound:ic_jp_raise-one's-hand.mp3]
もちあげる | mochiageru | lift up | [sound:ic_jp_lift-up.mp3]
ぶらさがる | burasagaru | hang | [sound:ic_jp_hang.mp3]
ほる | horu | dig | [sound:ic_jp_dig.mp3]
おす | osu | push | [sound:ic_jp_push.mp3]
のぼる | noboru | climb | [sound:ic_jp_climb.mp3]
あたまをふる | atama o furu | shake one's head | [sound:ic_jp_shake-one's-head.mp3]
ひねる | hineru | sprain | [sound:ic_jp_sprain.mp3]
ねじる | nejiru | twist | [sound:ic_jp_twist.mp3]
とる | toru | catch | [sound:ic_jp_catch.mp3]
たいかく | taikaku | build | [sound:ic_jp_build.mp3]
けんこうてき | kenkō-teki | healthy | [sound:ic_jp_healthy.mp3]
やせている | yasete iru | skinny | [sound:ic_jp_skinny.mp3]
せがひくい | se ga hikui | short | [sound:ic_jp_short.mp3]
せがたかい | se ga takai | tall | [sound:ic_jp_tall.mp3]
スリム | surimu | slim | [sound:ic_jp_slim.mp3]
たいけい | taikei | body type | [sound:ic_jp_body-type.mp3]
たいかく | taikaku | figure | [sound:ic_jp_figure.mp3]
たいかく | taikaku | frame | [sound:ic_jp_frame.mp3]
からだつき | karadatsuki | figure | [sound:ic_jp_figure.mp3]
からだつき | karadatsuki | frame | [sound:ic_jp_frame.mp3]
ふとった | futotta | thick | [sound:ic_jp_thick.mp3]
やせた | yaseta | thin | [sound:ic_jp_thin.mp3]
あせをかく | ase o kaku | sweat | [sound:ic_jp_sweat.mp3]
くしゃみをする | kushami o suru | sneeze | [sound:ic_jp_sneeze.mp3]
つば | tsuba | saliva | [sound:ic_jp_saliva.mp3]
しゃっくりをする | shakkuri o suru | hiccup | [sound:ic_jp_hiccup.mp3]
おしっこをする | oshikko o suru | urinate | [sound:ic_jp_urinate.mp3]
おならをする | onara o suru | pass gas | [sound:ic_jp_pass-gas.mp3]
おならをする | onara o suru | fart | [sound:ic_jp_fart.mp3]
なく | naku | cry | [sound:ic_jp_cry.mp3]
なみだ | namida | tear | [sound:ic_jp_tear.mp3]
ニキビ | nikibi | pimple | [sound:ic_jp_pimple.mp3]
あせ | ase | sweat | [sound:ic_jp_sweat.mp3]
せきをする | seki o suru | cough | [sound:ic_jp_cough.mp3]
ふきでる | fuki deru | break out | [sound:ic_jp_break-out.mp3]
だいべんをする | daiben o suru | defecate | [sound:ic_jp_defecate.mp3]
いきをする | iki o suru | breathe | [sound:ic_jp_breathe.mp3]
つばをはく | tsuba o haku | spit | [sound:ic_jp_spit.mp3]
かお | kao | face | [sound:ic_jp_face.mp3]
あご | ago | chin | [sound:ic_jp_chin.mp3]
みみ | mimi | ear | [sound:ic_jp_ear.mp3]
ひたい | hitai | forehead | [sound:ic_jp_forehead.mp3]
かみ | kami | hair | [sound:ic_jp_hair.mp3]
ブロンド | burondo | blonde hair | [sound:ic_jp_blonde-hair.mp3]
くろかみ | kurokami | black hair | [sound:ic_jp_black-hair.mp3]
ちゃぱつ | chapatsu | brown hair | [sound:ic_jp_brown-hair.mp3]
あかいかみ | akai kami | red hair | [sound:ic_jp_red-hair.mp3]
くち | kuchi | mouth | [sound:ic_jp_mouth.mp3]
くちひげ | kuchihige | mustache | [sound:ic_jp_mustache.mp3]
あごひげ | agohige | beard | [sound:ic_jp_beard.mp3]
ほお、ほほ | hō, hoho | cheek | [sound:ic_jp_cheek.mp3]
はな | hana | nose | [sound:ic_jp_nose.mp3]
は | ha | tooth | [sound:ic_jp_tooth.mp3]
シワ | shiwa | wrinkle | [sound:ic_jp_wrinkle.mp3]
まゆげ | mayuge | eyebrow | [sound:ic_jp_eyebrow.mp3]
まぶた | mabuta | eyelid | [sound:ic_jp_eyelid.mp3]
め | me | eye | [sound:ic_jp_eye.mp3]
まつげ | matsuge | eyelash | [sound:ic_jp_eyelash.mp3]
かおのけ | kao no ke | facial hair | [sound:ic_jp_facial-hair.mp3]
した | shita | tongue | [sound:ic_jp_tongue.mp3]
みらい | mirai | taste bud | [sound:ic_jp_taste-bud.mp3]
はなのあな | hana no ana | nostril | [sound:ic_jp_nostril.mp3]
は | ha | teeth | [sound:ic_jp_teeth.mp3]
くちびる | kuchibiru | lip | [sound:ic_jp_lip.mp3]
もも | momo | thigh | [sound:ic_jp_thigh.mp3]
ふくらはぎ | fukurahagi | calf | [sound:ic_jp_calf.mp3]
しり | shiri | buttocks | [sound:ic_jp_buttocks.mp3]
あしのつめ | ashi no tsume | toenail | [sound:ic_jp_toenail.mp3]
かかと | kakato | heel | [sound:ic_jp_heel.mp3]
こし | koshi | waist | [sound:ic_jp_waist.mp3]
ひざのさら | hiza no sara | kneecap | [sound:ic_jp_kneecap.mp3]
また | mata | groin | [sound:ic_jp_groin.mp3]
アキレスけん | akiresuken | Achilles' heel | [sound:ic_jp_Achilles'-heel.mp3]
かた | kata | shoulder | [sound:ic_jp_shoulder.mp3]
ぜんわん | zenwan | forearm | [sound:ic_jp_forearm.mp3]
おやゆび | oyayubi | thumb | [sound:ic_jp_thumb.mp3]
こゆび | koyubi | pinkie | [sound:ic_jp_pinkie.mp3]
なかゆび | nakayubi | middle finger | [sound:ic_jp_middle-finger.mp3]
ひとさしゆび | hitosashiyubi | index finger | [sound:ic_jp_index-finger.mp3]
くすりゆび | kusuriyubi | ring finger | [sound:ic_jp_ring-finger.mp3]
あばら | abara | rib | [sound:ic_jp_rib.mp3]
ふくぶ | fukubu | abdomen | [sound:ic_jp_abdomen.mp3]
ふくぶ | fukubu | belly | [sound:ic_jp_belly.mp3]
おなか | onaka | abdomen | [sound:ic_jp_abdomen.mp3]
おなか | onaka | belly | [sound:ic_jp_belly.mp3]
せぼね | sebone | spine | [sound:ic_jp_spine.mp3]
じんぞう | jinzō | kidney | [sound:ic_jp_kidney.mp3]
けんこうこつ | kenkōkotsu | shoulder blade | [sound:ic_jp_shoulder-blade.mp3]
せっけん | sekken | soap | [sound:ic_jp_soap.mp3]
はさみ | hasami | scissors | [sound:ic_jp_scissors.mp3]
ほうたい | hōtai | bandage | [sound:ic_jp_bandage.mp3]
つかいすててぶくろ | tsukaisute tebukuro | disposable gloves | [sound:ic_jp_disposable-gloves.mp3]
ピンセット | pinsetto | tweezers | [sound:ic_jp_tweezers.mp3]
ばんそうこう | bansōkō | adhesive bandage | [sound:ic_jp_adhesive-bandage.mp3]
ねんちゃくテープ | nenchaku tēpu | adhesive tape | [sound:ic_jp_adhesive-tape.mp3]
バンドエイド | bandoeido | bandaid | [sound:ic_jp_bandaid.mp3]
たいおん | taion | body temperature | [sound:ic_jp_body-temperature.mp3]
ねつをはかる | netsu o hakaru | take one's temperature | [sound:ic_jp_take-one's-temperature.mp3]
しゅじゅつ | shujutsu | operation | [sound:ic_jp_operation.mp3]
みゃくをとる | myaku o toru | take one's pulse | [sound:ic_jp_take-one's-pulse.mp3]
きんきゅうちりょうしつ | kinkyū chiryōshitsu | emergency room | [sound:ic_jp_emergency-room.mp3]
ちゅうしゃする | chūsha suru | give an injection | [sound:ic_jp_give-an-injection.mp3]
かんごし | kangoshi | nurse | [sound:ic_jp_nurse.mp3]
いしゃ | isha | medical doctor | [sound:ic_jp_medical-doctor.mp3]
いしゃ | isha | doctor | [sound:ic_jp_doctor.mp3]
いしゃ | isha | medical doctor | [sound:ic_jp_medical-doctor.mp3]
いしゃ | isha | doctor | [sound:ic_jp_doctor.mp3]
かんじゃ | kanja | patient | [sound:ic_jp_patient.mp3]
びょうれき | byōreki | medical history | [sound:ic_jp_medical-history.mp3]
ほけん | hoken | insurance | [sound:ic_jp_insurance.mp3]
レントゲン | rentogen | X-ray | [sound:ic_jp_X-ray.mp3]
けつえきけんさ | ketsueki kensa | blood test | [sound:ic_jp_blood-test.mp3]
てんてき | tenteki | intravenous | [sound:ic_jp_intravenous.mp3]
びょういん | byōin | hospital | [sound:ic_jp_hospital.mp3]
しんりょうじょ | shinryōjo | doctor's office | [sound:ic_jp_doctor's-office.mp3]
たいおんけい | taionkei | thermometer | [sound:ic_jp_thermometer.mp3]
ちゅうしゃ | chūsha | needle | [sound:ic_jp_needle.mp3]
ちゅうしゃき | chūshaki | needle | [sound:ic_jp_needle.mp3]
ひげそり | higesori | shaving razor | [sound:ic_jp_shaving-razor.mp3]
ハンドタオル | hando taoru | washcloth | [sound:ic_jp_washcloth.mp3]
タオル | taoru | towel | [sound:ic_jp_towel.mp3]
はぶらし | haburashi | toothbrush | [sound:ic_jp_toothbrush.mp3]
はみがきこ | ha migakiko | toothpaste | [sound:ic_jp_toothpaste.mp3]
シャンプー | shanpū | shampoo | [sound:ic_jp_shampoo.mp3]
リンス | rinsu | conditioner | [sound:ic_jp_conditioner.mp3]
デオドラント | deodoranto | deodorant | [sound:ic_jp_deodorant.mp3]
えきたいせっけん | ekitai sekken | liquid soap | [sound:ic_jp_liquid-soap.mp3]
シャワー | shawā | shower | [sound:ic_jp_shower.mp3]
そる | soru | shave | [sound:ic_jp_shave.mp3]
とかす | tokasu | comb | [sound:ic_jp_comb.mp3]
ふろにはいる | furo ni hairu | take a bath | [sound:ic_jp_take-a-bath.mp3]
かみにブラシをかける | kami ni burashi o kakeru | brush | [sound:ic_jp_brush.mp3]
うがいをする | ugai o suru | gargle | [sound:ic_jp_gargle.mp3]
きる | kiru | cut | [sound:ic_jp_cut.mp3]
かわかす | kawakasu | blow-dry | [sound:ic_jp_blow-dry.mp3]
かんせん | kansen | infection | [sound:ic_jp_infection.mp3]
ぐあいがわるい | guai ga warui | sick | [sound:ic_jp_sick.mp3]
ぜんそく | zensoku | asthma | [sound:ic_jp_asthma.mp3]
びょうき | byōki | illness | [sound:ic_jp_illness.mp3]
アレルギー | arerugī | allergy | [sound:ic_jp_allergy.mp3]
インフルエンザ | infuruenza | flu | [sound:ic_jp_flu.mp3]
かぜ | kaze | cold | [sound:ic_jp_cold.mp3]
やけど | yakedo | burn | [sound:ic_jp_burn.mp3]
けが | kega | injury | [sound:ic_jp_injury.mp3]
きりきず | kirikizu | cut | [sound:ic_jp_cut.mp3]
おる | oru | break | [sound:ic_jp_break.mp3]
しょほうせん | shohōsen | prescription | [sound:ic_jp_prescription.mp3]
くすり | kusuri | medicine | [sound:ic_jp_medicine.mp3]
せきどめ | sekidome | cough syrup | [sound:ic_jp_cough-syrup.mp3]
アスピリン | asupirin | aspirin | [sound:ic_jp_aspirin.mp3]
こうせいぶっしつ | kōsei busshitsu | antibiotic | [sound:ic_jp_antibiotic.mp3]
ワクチン | wakuchin | vaccine | [sound:ic_jp_vaccine.mp3]
かぜぐすり | kazegusuri | cold medicine | [sound:ic_jp_cold-medicine.mp3]
いたみ　 | itami | pain | [sound:ic_jp_pain.mp3]
ほっしん | hosshin | rash | [sound:ic_jp_rash.mp3]
せき | seki | cough | [sound:ic_jp_cough.mp3]
ずつう | zutsū | headache | [sound:ic_jp_headache.mp3]
はきけ | hakike | nausea | [sound:ic_jp_nausea.mp3]
つかれ | tsukare | fatigue | [sound:ic_jp_fatigue.mp3]
げり | geri | diarrhea | [sound:ic_jp_diarrhea.mp3]
かゆみ | kayumi | itch | [sound:ic_jp_itch.mp3]
しょうじょう | shōjō | symptom | [sound:ic_jp_symptom.mp3]
いつう | itsū | stomachache | [sound:ic_jp_stomachache.mp3]
ねつ | netsu | fever | [sound:ic_jp_fever.mp3]
のどがいたい | nodo ga itai | sore throat | [sound:ic_jp_sore-throat.mp3]
はなみず | hanamizu | runny nose | [sound:ic_jp_runny-nose.mp3]
めまいがする | memai ga suru | dizzy | [sound:ic_jp_dizzy.mp3]
はなづまり | hanazumari | stuffy nose | [sound:ic_jp_stuffy-nose.mp3]
まど | mado | window | [sound:ic_jp_window.mp3]
テレビ | terebi | television | [sound:ic_jp_television.mp3]
ほんだな | hondana | bookshelf | [sound:ic_jp_bookshelf.mp3]
ベッド | beddo | bed | [sound:ic_jp_bed.mp3]
かがみ | kagami | mirror | [sound:ic_jp_mirror.mp3]
たんす | tansu | dresser | [sound:ic_jp_dresser.mp3]
めざましどけい | mezamashidokei | alarm clock | [sound:ic_jp_alarm-clock.mp3]
ドア | doa | door | [sound:ic_jp_door.mp3]
リモコン | rimokon | remote control | [sound:ic_jp_remote-control.mp3]
つくえ | tsukue | desk | [sound:ic_jp_desk.mp3]
かぐ | kagu | furniture | [sound:ic_jp_furniture.mp3]
あしおき | ashioki | footrest | [sound:ic_jp_footrest.mp3]
ナイトテーブル | naitotēburu | nightstand | [sound:ic_jp_nightstand.mp3]
コーヒーテーブル | kōhī tēburu | coffee table | [sound:ic_jp_coffee-table.mp3]
いす | isu | chair | [sound:ic_jp_chair.mp3]
ソファー | sofā | sofa | [sound:ic_jp_sofa.mp3]
ダイニングテーブル | dainingu tēburu | dinner table | [sound:ic_jp_dinner-table.mp3]
テーブル | tēburu | table | [sound:ic_jp_table.mp3]
しょさい | shosai | study | [sound:ic_jp_study.mp3]
ちか | chika | basement | [sound:ic_jp_basement.mp3]
しんしつ | shinshitsu | bedroom | [sound:ic_jp_bedroom.mp3]
トイレ | toire | toilet | [sound:ic_jp_toilet.mp3]
だいどころ | daidokoro | kitchen | [sound:ic_jp_kitchen.mp3]
かってぐち | katteguchi | back door | [sound:ic_jp_back-door.mp3]
バスルーム | basurūmu | bathroom | [sound:ic_jp_bathroom.mp3]
ゆか | yuka | floor | [sound:ic_jp_floor.mp3]
かべ | kabe | wall | [sound:ic_jp_wall.mp3]
てんじょう | tenjō | ceiling | [sound:ic_jp_ceiling.mp3]
いま | ima | living room | [sound:ic_jp_living-room.mp3]
ダイニングルーム | dainingurūmu | dining room | [sound:ic_jp_dining-room.mp3]
したのかい | shita no kai | downstairs | [sound:ic_jp_downstairs.mp3]
やねうら | yaneura | attic | [sound:ic_jp_attic.mp3]
クローゼット | kurōzetto | closet | [sound:ic_jp_closet.mp3]
ろうか | rōka | hallway | [sound:ic_jp_hallway.mp3]
うらにわ | uraniwa | backyard | [sound:ic_jp_backyard.mp3]
とぐち | toguchi | doorway | [sound:ic_jp_doorway.mp3]
へや | heya | room | [sound:ic_jp_room.mp3]
しばふ | shibafu | grass | [sound:ic_jp_grass.mp3]
いりぐち | iriguchi | entry | [sound:ic_jp_entry.mp3]
にわ | niwa | garden | [sound:ic_jp_garden.mp3]
アパート | apāto | apartment | [sound:ic_jp_apartment.mp3]
いえ | ie | house | [sound:ic_jp_house.mp3]
バルコニー | barukonī | balcony | [sound:ic_jp_balcony.mp3]
いえ | ie | home | [sound:ic_jp_home.mp3]
でんしれんじ | denshi renji | microwave oven | [sound:ic_jp_microwave-oven.mp3]
れいぞうこ | reizōko | refrigerator | [sound:ic_jp_refrigerator.mp3]
そうじき | sōjiki | vacuum cleaner | [sound:ic_jp_vacuum-cleaner.mp3]
せんたくき | sentakuki | washing machine | [sound:ic_jp_washing-machine.mp3]
ディーブイディープレーヤー | dībuidī purēyā | DVD player | [sound:ic_jp_DVD-player.mp3]
せんぷうき | senpūki | fan | [sound:ic_jp_fan.mp3]
エアコン | eakon | air conditioner | [sound:ic_jp_air-conditioner.mp3]
エアコン | eakon | air conditioner | [sound:ic_jp_air-conditioner.mp3]
エアコン | eakon | air conditioner | [sound:ic_jp_air-conditioner.mp3]
エアコン | eakon | air conditioner | [sound:ic_jp_air-conditioner.mp3]
コンロ | konro | stove | [sound:ic_jp_stove.mp3]
でんしれんじ | denshi renji | microwave | [sound:ic_jp_microwave.mp3]
でんしレンジ | denshirenji | microwave oven | [sound:ic_jp_microwave-oven.mp3]
でんしレンジ | denshirenji | microwave | [sound:ic_jp_microwave.mp3]
すいはんき | suihanki | electric rice cooker | [sound:ic_jp_electric-rice-cooker.mp3]
オーブン | ōbun | oven | [sound:ic_jp_oven.mp3]
ドライヤー | doraiyā | hair dryer | [sound:ic_jp_hair-dryer.mp3]
でんきようプラグ | denki-yō puragu | electric plug | [sound:ic_jp_electric-plug.mp3]
ビデオ | bideo | VCR | [sound:ic_jp_VCR.mp3]
レコードプレーヤー | rekōdo purēyā | record player | [sound:ic_jp_record-player.mp3]
しょっきあらいき | shokkiaraiki | dishwasher | [sound:ic_jp_dishwasher.mp3]
コンセント | konsento | power outlet | [sound:ic_jp_power-outlet.mp3]
コンセント | konsento | power socket | [sound:ic_jp_power-socket.mp3]
ソケット | soketto | power outlet | [sound:ic_jp_power-outlet.mp3]
ソケット | soketto | power socket | [sound:ic_jp_power-socket.mp3]
しょうめい | shōmei | lamp | [sound:ic_jp_lamp.mp3]
カーペット | kāpetto | carpet | [sound:ic_jp_carpet.mp3]
マット | matto | mat | [sound:ic_jp_mat.mp3]
かべかけどけい | kabekake dokei | wall clock | [sound:ic_jp_wall-clock.mp3]
キッチンテーブル | kitchin tēburu | kitchen table | [sound:ic_jp_kitchen-table.mp3]
カーテン | kāten | curtain | [sound:ic_jp_curtain.mp3]
ロッキングチェア | rokkinguchea | rocking chair | [sound:ic_jp_rocking-chair.mp3]
テーブル | tēburu | table | [sound:ic_jp_table.mp3]
マット | matto | rug | [sound:ic_jp_rug.mp3]
どうぐばこ | dōgubako | toolbox | [sound:ic_jp_toolbox.mp3]
まきじゃく | makijaku | tape measure | [sound:ic_jp_tape-measure.mp3]
すいじゅんき | suijunki | level | [sound:ic_jp_level.mp3]
ネジ | neji | screw | [sound:ic_jp_screw.mp3]
ドライバー | doraibā | screwdriver | [sound:ic_jp_screwdriver.mp3]
かなづち | kanazuchi | hammer | [sound:ic_jp_hammer.mp3]
のこぎり | nokogiri | saw | [sound:ic_jp_saw.mp3]
ふく | fuku | wipe | [sound:ic_jp_wipe.mp3]
そうじする | sōji suru | clean | [sound:ic_jp_clean.mp3]
かわかす | kawakasu | dry | [sound:ic_jp_dry.mp3]
ほこり | hokori | dust | [sound:ic_jp_dust.mp3]
そうじきをかける | sōjiki o kakeru | vacuum | [sound:ic_jp_vacuum.mp3]
はく | haku | sweep | [sound:ic_jp_sweep.mp3]
かたづける | katazukeru | put away | [sound:ic_jp_put-away.mp3]
モップをかける | moppu o kakeru | mop | [sound:ic_jp_mop.mp3]
だす | dasu | take out | [sound:ic_jp_take-out.mp3]
でんきゅう | denkyū | light bulb | [sound:ic_jp_light-bulb.mp3]
でんち | denchi | battery | [sound:ic_jp_battery.mp3]
トイレットペーパー | toirettopēpā | toilet paper | [sound:ic_jp_toilet-paper.mp3]
セロテープ | serotēpu | Scotch tape | [sound:ic_jp_Scotch-tape.mp3]
ゴミばこ | gomibako | garbage pail | [sound:ic_jp_garbage-pail.mp3]
ろうそく | rōsoku | candle | [sound:ic_jp_candle.mp3]
ティッシュ | tisshu | tissue | [sound:ic_jp_tissue.mp3]
ライター | raitā | lighter | [sound:ic_jp_lighter.mp3]
スポンジ | suponji | sponge | [sound:ic_jp_sponge.mp3]
はいざら | haizara | ashtray | [sound:ic_jp_ashtray.mp3]
コートハンガー | kōto hangā | coat hanger | [sound:ic_jp_coat-hanger.mp3]
せんぬき | sennuki | bottle opener | [sound:ic_jp_bottle-opener.mp3]
かんきり | kankiri | can opener | [sound:ic_jp_can-opener.mp3]
マッチ | matchi | match | [sound:ic_jp_match.mp3]
おおがたごみばこ | ōgata gomibako | dumpster | [sound:ic_jp_dumpster.mp3]
フライパン | furaipan | frying pan | [sound:ic_jp_frying-pan.mp3]
まないた | manaita | cutting board | [sound:ic_jp_cutting-board.mp3]
せんめんだい | senmendai | sink | [sound:ic_jp_sink.mp3]
ボウル | bōru | bowl | [sound:ic_jp_bowl.mp3]
やかん | yakan | kettle | [sound:ic_jp_kettle.mp3]
なべ | nabe | pot | [sound:ic_jp_pot.mp3]
ふまん | fuman | unsatisfied | [sound:ic_jp_unsatisfied.mp3]
こわい | kowai | scared | [sound:ic_jp_scared.mp3]
きらい | kirai | dislike | [sound:ic_jp_dislike.mp3]
おとうと | otōto | younger brother | [sound:ic_jp_younger-brother.mp3]
あに | ani | older brother | [sound:ic_jp_older-brother.mp3]
いもうと | imōto | younger sister | [sound:ic_jp_younger-sister.mp3]
おねえさん | o-nee-san | older sister | [sound:ic_jp_older-sister.mp3]
おばあさん | o-bā-san | grandmother | [sound:ic_jp_grandmother.mp3]
おじいさん | o-jī-san | grandfather | [sound:ic_jp_grandfather.mp3]
おっと | otto | husband | [sound:ic_jp_husband.mp3]
つま | tsuma | wife | [sound:ic_jp_wife.mp3]
むすこ | musuko | son | [sound:ic_jp_son.mp3]
むすめ | musume | daughter | [sound:ic_jp_daughter.mp3]
じょうし | jōshi | boss | [sound:ic_jp_boss.mp3]
じょうし | jōshi | boss | [sound:ic_jp_boss.mp3]
じょうし | jōshi | boss | [sound:ic_jp_boss.mp3]
じょうし | jōshi | boss | [sound:ic_jp_boss.mp3]
～さん | ~san | Mr. | [sound:ic_jp_Mr..mp3]
～ふじん | ~fujin | Mrs. | [sound:ic_jp_Mrs..mp3]
どうりょう | dōryō | colleague | [sound:ic_jp_colleague.mp3]
どうきゅうせい | dōkyūsei | classmate | [sound:ic_jp_classmate.mp3]
おんなのひと | onna no hito | woman | [sound:ic_jp_woman.mp3]
おとこのひと | otoko no hito | man | [sound:ic_jp_man.mp3]
かのじょ | kanojo | girlfriend | [sound:ic_jp_girlfriend.mp3]
かれし | kareshi | boyfriend | [sound:ic_jp_boyfriend.mp3]
パートナー | pātonā | partner | [sound:ic_jp_partner.mp3]
こども | kodomo | child | [sound:ic_jp_child.mp3]
りんじん | rinjin | neighbor | [sound:ic_jp_neighbor.mp3]
わかもの | wakamono | youth | [sound:ic_jp_youth.mp3]
おとしより | o-toshiyori | elderly | [sound:ic_jp_elderly.mp3]
ともだち | tomo-dachi | friend | [sound:ic_jp_friend.mp3]
おとな | otona | adult | [sound:ic_jp_adult.mp3]
あかちゃん | aka-chan | baby | [sound:ic_jp_baby.mp3]
こうれいしゃ | kōreisha | senior citizen | [sound:ic_jp_senior-citizen.mp3]
おんなのこ | onna no ko | girl | [sound:ic_jp_girl.mp3]
おとこのこ | otoko no ko | boy | [sound:ic_jp_boy.mp3]
しんせいじ | shinseiji | newborn baby | [sound:ic_jp_newborn-baby.mp3]
こわい | kowai | afraid | [sound:ic_jp_afraid.mp3]
イライラする | iraira suru | upset | [sound:ic_jp_upset.mp3]
さびしい | sabishii | lonely | [sound:ic_jp_lonely.mp3]
しんぱいする | shinpai suru | worry | [sound:ic_jp_worry.mp3]
ふあんになる | fuan ni naru | anxious | [sound:ic_jp_anxious.mp3]
ふあんになる | fuan ni naru | nervous | [sound:ic_jp_nervous.mp3]
きんちょうする | kinchō suru | anxious | [sound:ic_jp_anxious.mp3]
ほこりにおもう | hokori ni omou | proud | [sound:ic_jp_proud.mp3]
すき | suki | like | [sound:ic_jp_like.mp3]
きょうみがある | kyōmi ga aru | interested | [sound:ic_jp_interested.mp3]
くつろいでいる | kutsuroide iru | relaxed | [sound:ic_jp_relaxed.mp3]
たんき | tanki | short-tempered | [sound:ic_jp_short-tempered.mp3]
ていねい | teinei | polite | [sound:ic_jp_polite.mp3]
いあつてき | iatsu-teki | overbearing | [sound:ic_jp_overbearing.mp3]
きびしい | kibishii | strict | [sound:ic_jp_strict.mp3]
ずばぬけた | zubanuketa | outstanding | [sound:ic_jp_outstanding.mp3]
すばらしい | subarashii | great | [sound:ic_jp_great.mp3]
オープン | ōpun | open | [sound:ic_jp_open.mp3]
かしこい | kashikoi | clever | [sound:ic_jp_clever.mp3]
めだった | medatta | remarkable | [sound:ic_jp_remarkable.mp3]
げんき | genki | lively | [sound:ic_jp_lively.mp3]
ずるがしこい | zurugashikoi | cunning | [sound:ic_jp_cunning.mp3]
ずるがしこい | zurugashikoi | sly | [sound:ic_jp_sly.mp3]
ずるい | zurui | cunning | [sound:ic_jp_cunning.mp3]
ずるい | zurui | sly | [sound:ic_jp_sly.mp3]
こうどうてき | kōdō-teki | active | [sound:ic_jp_active.mp3]
せいじつ | seijitsu | honest | [sound:ic_jp_honest.mp3]
あたたかい | atatakai | warm | [sound:ic_jp_warm.mp3]
とり | tori | bird | [sound:ic_jp_bird.mp3]
コオロギ | kōrogi | cricket | [sound:ic_jp_cricket.mp3]
ハムスター | hamusutā | hamster | [sound:ic_jp_hamster.mp3]
いぬ | inu | dog | [sound:ic_jp_dog.mp3]
ねこ | neko | cat | [sound:ic_jp_cat.mp3]
うま | uma | horse | [sound:ic_jp_horse.mp3]
さかな | sakana | fish | [sound:ic_jp_fish.mp3]
おおや | ōya | landlord | [sound:ic_jp_landlord.mp3]
りょう | ryō | dormitory | [sound:ic_jp_dormitory.mp3]
きょうどうじゅうたく | kyōdō jūtaku | apartment building | [sound:ic_jp_apartment-building.mp3]
まち | machi | city | [sound:ic_jp_city.mp3]
のうじょう | nōjō | farm | [sound:ic_jp_farm.mp3]
いなか | inaka | country | [sound:ic_jp_country.mp3]
むら | mura | village | [sound:ic_jp_village.mp3]
まち | machi | town | [sound:ic_jp_town.mp3]
ベッドタウン | beddotaun | suburb | [sound:ic_jp_suburb.mp3]
かえる | kaeru | frog | [sound:ic_jp_frog.mp3]
イモリ | imori | newt | [sound:ic_jp_newt.mp3]
エミュー | emyū | emu | [sound:ic_jp_emu.mp3]
カモノハシ | kamonohashi | platypus | [sound:ic_jp_platypus.mp3]
カンガルー | kangarū | kangaroo | [sound:ic_jp_kangaroo.mp3]
コアラ | koara | koala | [sound:ic_jp_koala.mp3]
ウォンバット | wonbatto | wombat | [sound:ic_jp_wombat.mp3]
ライオン | raion | lion | [sound:ic_jp_lion.mp3]
チーター | chītā | cheetah | [sound:ic_jp_cheetah.mp3]
ジャガー | jagā | jaguar | [sound:ic_jp_jaguar.mp3]
とら | tora | tiger | [sound:ic_jp_tiger.mp3]
メスライオン | mesu raion | lioness | [sound:ic_jp_lioness.mp3]
うし | ushi | cow | [sound:ic_jp_cow.mp3]
ぶた | buta | pig | [sound:ic_jp_pig.mp3]
ひつじ | hitsuji | sheep | [sound:ic_jp_sheep.mp3]
ヤギ | yagi | goat | [sound:ic_jp_goat.mp3]
にわとり | niwatori | chicken | [sound:ic_jp_chicken.mp3]
フクロウ | fukurō | owl | [sound:ic_jp_owl.mp3]
アライグマ | araiguma | raccoon | [sound:ic_jp_raccoon.mp3]
ビーバー | bībā | beaver | [sound:ic_jp_beaver.mp3]
わし | washi | eagle | [sound:ic_jp_eagle.mp3]
くま | kuma | bear | [sound:ic_jp_bear.mp3]
しか | shika | deer | [sound:ic_jp_deer.mp3]
バッファロー　 | baffarō | buffalo | [sound:ic_jp_buffalo.mp3]
おおかみ | ōkami | wolf | [sound:ic_jp_wolf.mp3]
キツネ | kitsune | fox | [sound:ic_jp_fox.mp3]
ゴリラ | gorira | gorilla | [sound:ic_jp_gorilla.mp3]
いのしし | inoshishi | wild boar | [sound:ic_jp_wild-boar.mp3]
コウモリ | kōmori | bat | [sound:ic_jp_bat.mp3]
アリクイ | arikui | anteater | [sound:ic_jp_anteater.mp3]
チンパンジー | chinpanjī | chimpanzee | [sound:ic_jp_chimpanzee.mp3]
ぞう | zō | elephant | [sound:ic_jp_elephant.mp3]
キリン | kirin | giraffe | [sound:ic_jp_giraffe.mp3]
シマウマ | shimauma | zebra | [sound:ic_jp_zebra.mp3]
さる | saru | monkey | [sound:ic_jp_monkey.mp3]
サイ | sai | rhinoceros | [sound:ic_jp_rhinoceros.mp3]
おんどり | ondori | rooster | [sound:ic_jp_rooster.mp3]
しちめんちょう | shichimenchō | turkey | [sound:ic_jp_turkey.mp3]
はと | hato | pigeon | [sound:ic_jp_pigeon.mp3]
かも | kamo | duck | [sound:ic_jp_duck.mp3]
カラス | karasu | crow | [sound:ic_jp_crow.mp3]
ウズラ | uzura | quail | [sound:ic_jp_quail.mp3]
ハゲタカ | hagetaka | vulture | [sound:ic_jp_vulture.mp3]
クジャク | kujaku | peacock | [sound:ic_jp_peacock.mp3]
つる | tsuru | crane | [sound:ic_jp_crane.mp3]
はくちょう | hakuchō | swan | [sound:ic_jp_swan.mp3]
かもめ | kamome | seagull | [sound:ic_jp_seagull.mp3]
ゴキブリ | gokiburi | cockroach | [sound:ic_jp_cockroach.mp3]
か | ka | mosquito | [sound:ic_jp_mosquito.mp3]
はち | hachi | bee | [sound:ic_jp_bee.mp3]
ハエ | hae | fly | [sound:ic_jp_fly.mp3]
ブヨ | buyo | gnat | [sound:ic_jp_gnat.mp3]
クモ | kumo | spider | [sound:ic_jp_spider.mp3]
アリ | ari | ant | [sound:ic_jp_ant.mp3]
こうちゅうるい | kōchūrui | beetle | [sound:ic_jp_beetle.mp3]
せみ | semi | cicada | [sound:ic_jp_cicada.mp3]
むし | mushi | bug | [sound:ic_jp_bug.mp3]
ホタル | hotaru | firefly | [sound:ic_jp_firefly.mp3]
シャクトリムシ | shakutorimushi | inchworm | [sound:ic_jp_inchworm.mp3]
テントウムシ | tentōmushi | ladybug | [sound:ic_jp_ladybug.mp3]
ミミズ | mimizu | worm | [sound:ic_jp_worm.mp3]
けむし | kemushi | caterpillar | [sound:ic_jp_caterpillar.mp3]
おか | oka | hill | [sound:ic_jp_hill.mp3]
れっとう | rettō | archipelago | [sound:ic_jp_archipelago.mp3]
ほんど | hondo | mainland | [sound:ic_jp_mainland.mp3]
やま | yama | mountain | [sound:ic_jp_mountain.mp3]
はま | hama | beach | [sound:ic_jp_beach.mp3]
さんみゃく | sanmyaku | mountain range | [sound:ic_jp_mountain-range.mp3]
ねったいうりん | nettai urin | rain forest | [sound:ic_jp_rain-forest.mp3]
しま | shima | island | [sound:ic_jp_island.mp3]
もり | mori | forest | [sound:ic_jp_forest.mp3]
かわ | kawa | river | [sound:ic_jp_river.mp3]
いけ | ike | pond | [sound:ic_jp_pond.mp3]
ぬまち | numachi | marsh | [sound:ic_jp_marsh.mp3]
うみ | umi | ocean | [sound:ic_jp_ocean.mp3]
かいきょう | kaikyō | strait | [sound:ic_jp_strait.mp3]
うみべ | umibe | seaside | [sound:ic_jp_seaside.mp3]
みずうみ | mizuumi | lake | [sound:ic_jp_lake.mp3]
のはら | nohara | field | [sound:ic_jp_field.mp3]
そうげん | sōgen | grassland | [sound:ic_jp_grassland.mp3]
あれち | arechi | wasteland | [sound:ic_jp_wasteland.mp3]
そら | sora | sky | [sound:ic_jp_sky.mp3]
たき | taki | waterfall | [sound:ic_jp_waterfall.mp3]
さばく | sabaku | desert | [sound:ic_jp_desert.mp3]
どじょう | dojō | soil | [sound:ic_jp_soil.mp3]
つち | tsuchi | dirt | [sound:ic_jp_dirt.mp3]
いし | ishi | rock | [sound:ic_jp_rock.mp3]
バラ | bara | rose | [sound:ic_jp_rose.mp3]
はな | hana | flower | [sound:ic_jp_flower.mp3]
ユリ | yuri | lily | [sound:ic_jp_lily.mp3]
ヒマワリ | himawari | sunflower | [sound:ic_jp_sunflower.mp3]
タンポポ | tanpopo | dandelion | [sound:ic_jp_dandelion.mp3]
ネズミ | nezumi | mouse | [sound:ic_jp_mouse.mp3]
うさぎ | usagi | rabbit | [sound:ic_jp_rabbit.mp3]
こひつじ | kohitsuji | lamb | [sound:ic_jp_lamb.mp3]
あざらし | azarashi | seal | [sound:ic_jp_seal.mp3]
タコ | tako | octopus | [sound:ic_jp_octopus.mp3]
サメ | same | shark | [sound:ic_jp_shark.mp3]
クジラ | kujira | whale | [sound:ic_jp_whale.mp3]
イルカ | iruka | dolphin | [sound:ic_jp_dolphin.mp3]
ウニ | uni | urchin | [sound:ic_jp_urchin.mp3]
オットセイ | ottosei | fur seal | [sound:ic_jp_fur-seal.mp3]
ロブスター | robusutā | lobster | [sound:ic_jp_lobster.mp3]
かに | kani | crab | [sound:ic_jp_crab.mp3]
エイ | ei | stingray | [sound:ic_jp_stingray.mp3]
イカ | ika | squid | [sound:ic_jp_squid.mp3]
クラゲ | kurage | jellyfish | [sound:ic_jp_jellyfish.mp3]
ひでり | hideri | drought | [sound:ic_jp_drought.mp3]
つなみ | tsunami | tsunami | [sound:ic_jp_tsunami.mp3]
なだれ | nadare | avalanche | [sound:ic_jp_avalanche.mp3]
かじ | kaji | fire | [sound:ic_jp_fire.mp3]
じしん | jishin | earthquake | [sound:ic_jp_earthquake.mp3]
すなあらし | suna'arashi | sandstorm | [sound:ic_jp_sandstorm.mp3]
は | ha | leaf | [sound:ic_jp_leaf.mp3]
さく | saku | bloom | [sound:ic_jp_bloom.mp3]
しぼむ | shibomu | wilt | [sound:ic_jp_wilt.mp3]
えだ | eda | branch | [sound:ic_jp_branch.mp3]
き | ki | tree | [sound:ic_jp_tree.mp3]
しげみ | shigemi | bush | [sound:ic_jp_bush.mp3]
たね | tane | seed | [sound:ic_jp_seed.mp3]
ざっそう | zassō | weed | [sound:ic_jp_weed.mp3]
へび | hebi | snake | [sound:ic_jp_snake.mp3]
カメ | kame | turtle | [sound:ic_jp_turtle.mp3]
ワニ | wani | crocodile | [sound:ic_jp_crocodile.mp3]
トカゲ | tokage | lizard | [sound:ic_jp_lizard.mp3]
ワニ | wani | alligator | [sound:ic_jp_alligator.mp3]
かし | kashi | oak tree | [sound:ic_jp_oak-tree.mp3]
カエデ | kaede | maple tree | [sound:ic_jp_maple-tree.mp3]
ね | ne | root | [sound:ic_jp_root.mp3]
まつ | matsu | pine tree | [sound:ic_jp_pine-tree.mp3]
すぎ | sugi | cedar tree | [sound:ic_jp_cedar-tree.mp3]
やなぎ | yanagi | willow tree | [sound:ic_jp_willow-tree.mp3]
あつい | atsui | hot | [sound:ic_jp_hot.mp3]
たいよう | taiyō | sun | [sound:ic_jp_sun.mp3]
てんき | tenki | weather | [sound:ic_jp_weather.mp3]
さむい | samui | cold | [sound:ic_jp_cold.mp3]
ど | do | degree | [sound:ic_jp_degree.mp3]
らいう | raiu | thunderstorm | [sound:ic_jp_thunderstorm.mp3]
すいぞくかん | suizokukan | aquarium | [sound:ic_jp_aquarium.mp3]
きんせいひん | kinseihin | contraband | [sound:ic_jp_contraband.mp3]
けんえき | ken'eki | quarantine | [sound:ic_jp_quarantine.mp3]
ぜいかん | zeikan | customs | [sound:ic_jp_customs.mp3]
しんこくようし | shinkoku yōshi | declaration form | [sound:ic_jp_declaration-form.mp3]
ばっきん | bakkin | fine | [sound:ic_jp_fine.mp3]
いほう | ihō | illegal | [sound:ic_jp_illegal.mp3]
めんぜい | menzei | tax-free | [sound:ic_jp_tax-free.mp3]
エントリーカード | entorī kādo | entry card | [sound:ic_jp_entry-card.mp3]
さいにゅうこくきょか | sai-nyūkoku kyoka | re-entry permit | [sound:ic_jp_re-entry-permit.mp3]
こくせき | kokuseki | nationality | [sound:ic_jp_nationality.mp3]
ビザ | biza | visa | [sound:ic_jp_visa.mp3]
パスポート | pasupōto | passport | [sound:ic_jp_passport.mp3]
けんさする | kensa suru | inspect | [sound:ic_jp_inspect.mp3]
おうしゅうする | ōshū suru | confiscate | [sound:ic_jp_confiscate.mp3]
しんこくする | shinkoku suru | declare | [sound:ic_jp_declare.mp3]
ぜいきんをはらう | zeikin o harau | pay taxes | [sound:ic_jp_pay-taxes.mp3]
きにゅうする | kinyū suru | fill out | [sound:ic_jp_fill-out.mp3]
しんせきをたずねる | shinseki o tazuneru | visit relatives | [sound:ic_jp_visit-relatives.mp3]
ちいさいしへい | chiisai shihei | small bill | [sound:ic_jp_small-bill.mp3]
かえる | kaeru | convert | [sound:ic_jp_convert.mp3]
かえる | kaeru | change | [sound:ic_jp_change.mp3]
かえる | kaeru | change | [sound:ic_jp_change.mp3]
りょうがえする | ryōgae suru | convert | [sound:ic_jp_convert.mp3]
りょうがえする | ryōgae suru | change | [sound:ic_jp_change.mp3]
りょうがえする | ryōgae suru | change | [sound:ic_jp_change.mp3]
りょうがえする | ryōgae suru | convert | [sound:ic_jp_convert.mp3]
りょうがえする | ryōgae suru | change | [sound:ic_jp_change.mp3]
りょうがえする | ryōgae suru | change | [sound:ic_jp_change.mp3]
かわせレート | kawase rēto | exchange rate | [sound:ic_jp_exchange-rate.mp3]
がいこくかわせ | gaikoku kawase | foreign exchange | [sound:ic_jp_foreign-exchange.mp3]
トラベラーズチェック | toraberāzuchekku | traveler's check | [sound:ic_jp_traveler's-check.mp3]
えん | en | Japanese Yen | [sound:ic_jp_Japanese-Yen.mp3]
ユーロ | yūro | Euro | [sound:ic_jp_Euro.mp3]
ポンド | pondo | British Pound | [sound:ic_jp_British-Pound.mp3]
アメリカドル | Amerika doru | United States Dollar | [sound:ic_jp_United-States-Dollar.mp3]
つうか | tsūka | currency | [sound:ic_jp_currency.mp3]
ぎんこう | ginkō | bank | [sound:ic_jp_bank.mp3]
こぎって | kogitte | check | [sound:ic_jp_check.mp3]
サスペンス | sasupensu | suspense | [sound:ic_jp_suspense.mp3]
まんが | manga | cartoon | [sound:ic_jp_cartoon.mp3]
アニメ | anime | animation | [sound:ic_jp_animation.mp3]
えいが | eiga | film | [sound:ic_jp_film.mp3]
えいが | eiga | movie | [sound:ic_jp_movie.mp3]
えいが | eiga | film | [sound:ic_jp_film.mp3]
ミステリー | misuterī | mystery | [sound:ic_jp_mystery.mp3]
ラブコメディー | rabu komedī | romantic comedy | [sound:ic_jp_romantic-comedy.mp3]
えんげき | engeki | drama | [sound:ic_jp_drama.mp3]
こうえん | kōen | performance | [sound:ic_jp_performance.mp3]
ドキュメンタリー | dokyumentarī | documentary | [sound:ic_jp_documentary.mp3]
ぶたいえんぎ | butai engi | stage play | [sound:ic_jp_stage-play.mp3]
せいゆう | seiyū | voice actor | [sound:ic_jp_voice-actor.mp3]
スター | sutā | star | [sound:ic_jp_star.mp3]
オーディオブック | ōdiobukku | audiobook | [sound:ic_jp_audiobook.mp3]
テレビゲーム | terebi gēmu | video game | [sound:ic_jp_video-game.mp3]
テレビばんぐみ | terebi bangumi | TV show | [sound:ic_jp_TV-show.mp3]
はしる | hashiru | run | [sound:ic_jp_run.mp3]
とぶ | tobu | jump | [sound:ic_jp_jump.mp3]
ける | keru | kick | [sound:ic_jp_kick.mp3]
ジョギング | jogingu | jogging | [sound:ic_jp_jogging.mp3]
うんどう | undō | exercise | [sound:ic_jp_exercise.mp3]
きゃくしつじょうむいん | kyakushitsu jōmuin | flight attendant | [sound:ic_jp_flight-attendant.mp3]
ざせき | zaseki | seat | [sound:ic_jp_seat.mp3]
エコノミークラス | ekonomī kurasu | economy class | [sound:ic_jp_economy-class.mp3]
フライト | furaito | flight | [sound:ic_jp_flight.mp3]
にもつ | nimotsu | luggage | [sound:ic_jp_luggage.mp3]
とうじょうけん | tōjōken | boarding pass | [sound:ic_jp_boarding-pass.mp3]
しゅっぱつゲート | shuppatsu gēto | departure gate | [sound:ic_jp_departure-gate.mp3]
しゅっぱつ | shuppatsu | departure | [sound:ic_jp_departure.mp3]
とうちゃく | tōchaku | arrival | [sound:ic_jp_arrival.mp3]
フライトナンバー | furaito nanbā | flight number | [sound:ic_jp_flight-number.mp3]
チェス | chesu | chess | [sound:ic_jp_chess.mp3]
ポーカー | pōkā | poker | [sound:ic_jp_poker.mp3]
しゅうじ | shūji | calligraphy | [sound:ic_jp_calligraphy.mp3]
おどる | odoru | dance | [sound:ic_jp_dance.mp3]
うたう | utau | sing a song | [sound:ic_jp_sing-a-song.mp3]
えんそうする | ensō suru | play a musical instrument | [sound:ic_jp_play-a-musical-instrument.mp3]
ロック | rokku | rock music | [sound:ic_jp_rock-music.mp3]
しゃしんをとる | shashin o toru | take a picture | [sound:ic_jp_take-a-picture.mp3]
インターネットをする | intānetto o suru | surf the net | [sound:ic_jp_surf-the-net.mp3]
きってをあつめる | kitte o atsumeru | collect stamps | [sound:ic_jp_collect-stamps.mp3]
きって | kitte | stamp | [sound:ic_jp_stamp.mp3]
アイススケート | aisu sukēto | ice skating | [sound:ic_jp_ice-skating.mp3]
げんご | gengo | language | [sound:ic_jp_language.mp3]
ぶじゅつ | bujutsu | martial arts | [sound:ic_jp_martial-arts.mp3]
つる | tsuru | fish | [sound:ic_jp_fish.mp3]
チェスをする | chesu o suru | play chess | [sound:ic_jp_play-chess.mp3]
ポーカーをする | pōkā o suru | play poker | [sound:ic_jp_play-poker.mp3]
しゅみをたのしむ | shumi o tanoshimu | enjoy a hobby | [sound:ic_jp_enjoy-a-hobby.mp3]
ウェイトトレーニング | weito torēningu | exercise | [sound:ic_jp_exercise.mp3]
ウェイトトレーニング | weito torēningu | work out | [sound:ic_jp_work-out.mp3]
うんどうする | undō suru | work out | [sound:ic_jp_work-out.mp3]
りょこう | ryokō | traveling | [sound:ic_jp_traveling.mp3]
うんどう | undō | exercising | [sound:ic_jp_exercising.mp3]
どくしょ | dokusho | reading | [sound:ic_jp_reading.mp3]
トランプ | toranpu | playing cards | [sound:ic_jp_playing-cards.mp3]
ロビー | robī | lobby | [sound:ic_jp_lobby.mp3]
シングルベッド | shinguru beddo | single bed | [sound:ic_jp_single-bed.mp3]
ダブルベッド | daburu beddo | double bed | [sound:ic_jp_double-bed.mp3]
ウェイクアップサービス | ueikuappu sābisu | wake-up service | [sound:ic_jp_wake-up-service.mp3]
スイート | suīto | suite | [sound:ic_jp_suite.mp3]
まんしつ | manshitsu | no vacancy | [sound:ic_jp_no-vacancy.mp3]
ルームサービス | rūmu sābisu | room service | [sound:ic_jp_room-service.mp3]
ホテル | hoteru | hotel | [sound:ic_jp_hotel.mp3]
フロント | furonto | front desk | [sound:ic_jp_front-desk.mp3]
ラウンジ | raunji | lounge | [sound:ic_jp_lounge.mp3]
ランドリーサービス | randorī sābisu | laundry service | [sound:ic_jp_laundry-service.mp3]
とうろくする | tōroku suru | sign in | [sound:ic_jp_sign-in.mp3]
とうろくする | tōroku suru | check in | [sound:ic_jp_check-in.mp3]
チェックインする | chekkuin suru | sign in | [sound:ic_jp_sign-in.mp3]
チェックインする | chekkuin suru | check in | [sound:ic_jp_check-in.mp3]
でんしキー | denshi kī | electronic key | [sound:ic_jp_electronic-key.mp3]
チェックアウトする | chekkuauto suru | check out | [sound:ic_jp_check-out.mp3]
へやばんごう | heya bangō | room number | [sound:ic_jp_room-number.mp3]
ルームキー | rūmu kī | room key | [sound:ic_jp_room-key.mp3]
よやく | yoyaku | reservation | [sound:ic_jp_reservation.mp3]
モーニングコール | mōningu kōru | wake-up call | [sound:ic_jp_wake-up-call.mp3]
あきべや | akibeya | vacancy | [sound:ic_jp_vacancy.mp3]
スポーツ | supōtsu | sports | [sound:ic_jp_sports.mp3]
こうえん | kōen | park | [sound:ic_jp_park.mp3]
あそびば | asobiba | playground | [sound:ic_jp_playground.mp3]
プール | pūru | pool | [sound:ic_jp_pool.mp3]
ピクニック | pikunikku | picnic | [sound:ic_jp_picnic.mp3]
かだん | kadan | flower garden | [sound:ic_jp_flower-garden.mp3]
むかえる | mukaeru | welcome | [sound:ic_jp_welcome.mp3]
じゆうにくつろいでください。 | Jiyū ni kutsuroide kudasai. | Make yourself at home. | [sound:ic_jp_Make-yourself-at-home..mp3]
わたしのなまえは～です。 | Watashi no namae wa ~ desu. | My name is… | [sound:ic_jp_My-name-is….mp3]
こんにちは。 | Konnichiwa | Hi. | [sound:ic_jp_Hi..mp3]
またせてごめんなさい。 | Matasete gomennasai. | Sorry to keep you waiting. | [sound:ic_jp_Sorry-to-keep-you-waiting..mp3]
いかがおすごしですか。 | Ikaga o-sugoshi desu ka. | How have you been? | [sound:ic_jp_How-have-you-been?.mp3]
これ、どうぞ。 | Kore, dōzo. | This is for you. | [sound:ic_jp_This-is-for-you..mp3]
ノックする | nokku suru | knock | [sound:ic_jp_knock.mp3]
どういたしまして。 | Dōitashimashite. | You're welcome. | [sound:ic_jp_You're-welcome..mp3]
おひさしぶりです。 | O-hisashiburi desu. | Long time no see. | [sound:ic_jp_Long-time-no-see..mp3]
こちらは～です。 | kochira wa ~ desu. | This is (person's name). | [sound:ic_jp_This-is-(person's-name)..mp3]
プロスポーツせんしゅ | puro supōtsu senshu | professional athlete | [sound:ic_jp_professional-athlete.mp3]
しょうしゃ | shōsha | winner | [sound:ic_jp_winner.mp3]
はいしゃ | haisha | loser | [sound:ic_jp_loser.mp3]
オリンピック | Orinpikku | Olympics | [sound:ic_jp_Olympics.mp3]
ワールドカップ | Wārudo kappu | World Cup | [sound:ic_jp_World-Cup.mp3]
チャンピオン | chanpion | champion | [sound:ic_jp_champion.mp3]
スタジアム | sutajiamu | stadium | [sound:ic_jp_stadium.mp3]
おうえんする | ōen suru | cheer | [sound:ic_jp_cheer.mp3]
じゅんけっしょう | junkesshō | semi-final | [sound:ic_jp_semi-final.mp3]
しあい | shiai | competition | [sound:ic_jp_competition.mp3]
しあい | shiai | game | [sound:ic_jp_game.mp3]
まける | makeru | lose | [sound:ic_jp_lose.mp3]
かつ | katsu | win | [sound:ic_jp_win.mp3]
けっしょうせん | kesshōsen | championship contest | [sound:ic_jp_championship-contest.mp3]
チーム | chīmu | team | [sound:ic_jp_team.mp3]
スポーツせんしゅ | supōtsu senshu | athlete | [sound:ic_jp_athlete.mp3]
せんしゅ | senshu | player | [sound:ic_jp_player.mp3]
マネージャー | manējā | manager | [sound:ic_jp_manager.mp3]
そうごうかくとうぎ | sōgō kakutōgi | mixed martial arts | [sound:ic_jp_mixed-martial-arts.mp3]
たっきゅう | takkyū | ping pong | [sound:ic_jp_ping-pong.mp3]
たいそう | taisō | gymnastics | [sound:ic_jp_gymnastics.mp3]
ランニング | ranningu | running | [sound:ic_jp_running.mp3]
すいえい | suiei | swimming | [sound:ic_jp_swimming.mp3]
じょうば | jōba | horseback riding | [sound:ic_jp_horseback-riding.mp3]
スキー | sukī | skiing | [sound:ic_jp_skiing.mp3]
りくじょう | rikujō | track and field | [sound:ic_jp_track-and-field.mp3]
テニス | tenisu | tennis | [sound:ic_jp_tennis.mp3]
バドミントン | badominton | badminton | [sound:ic_jp_badminton.mp3]
マラソン | marason | marathon | [sound:ic_jp_marathon.mp3]
ゴルフ | gorufu | golf | [sound:ic_jp_golf.mp3]
ボクシング | bokushingu | boxing | [sound:ic_jp_boxing.mp3]
サイクリング | saikuringu | cycling | [sound:ic_jp_cycling.mp3]
カーレース | kā rēsu | auto racing | [sound:ic_jp_auto-racing.mp3]
やきゅう | yakyū | baseball | [sound:ic_jp_baseball.mp3]
アイスホッケー | aisu hokkē | ice hockey | [sound:ic_jp_ice-hockey.mp3]
バレーボール | barēbōru | volleyball | [sound:ic_jp_volleyball.mp3]
バスケットボール | basukettobōru | basketball | [sound:ic_jp_basketball.mp3]
サッカー | sakkā | soccer | [sound:ic_jp_soccer.mp3]
フットボール | futtobōru | football | [sound:ic_jp_football.mp3]
サッカー | sakkā | football | [sound:ic_jp_football.mp3]
しつもん | shitsumon | question | [sound:ic_jp_question.mp3]
もじ | moji | letter | [sound:ic_jp_letter.mp3]
せいと | seito | student | [sound:ic_jp_student.mp3]
せんせい | sensei | teacher | [sound:ic_jp_teacher.mp3]
きゃくほん | kyakuhon | script | [sound:ic_jp_script.mp3]
どうし | dōshi | verb | [sound:ic_jp_verb.mp3]
めいし | meishi | noun | [sound:ic_jp_noun.mp3]
もじ | moji | character | [sound:ic_jp_character.mp3]
けいようし | keiyōshi | adjective | [sound:ic_jp_adjective.mp3]
おんどくする | ondoku suru | read aloud | [sound:ic_jp_read-aloud.mp3]
ふくしょうする | fukushō suru | repeat | [sound:ic_jp_repeat.mp3]
じゅぎょう | jugyō | lesson | [sound:ic_jp_lesson.mp3]
えいご | eigo | English | [sound:ic_jp_English.mp3]
まちがい | machigai | incorrect | [sound:ic_jp_incorrect.mp3]
ただしい | tadashii | correct | [sound:ic_jp_correct.mp3]
さくぶん | sakubun | written composition | [sound:ic_jp_written-composition.mp3]
なおす | naosu | correct | [sound:ic_jp_correct.mp3]
きっぷ | kippu | ticket | [sound:ic_jp_ticket.mp3]
ガイド | gaido | guide | [sound:ic_jp_guide.mp3]
ガイド | gaido | tour guide | [sound:ic_jp_tour-guide.mp3]
ツアーガイド | tsuā gaido | guide | [sound:ic_jp_guide.mp3]
ツアーガイド | tsuā gaido | tour guide | [sound:ic_jp_tour-guide.mp3]
りょこうしゃ | ryokōsha | tourist | [sound:ic_jp_tourist.mp3]
りょこうプラン | ryokō puran | itinerary | [sound:ic_jp_itinerary.mp3]
ガイドブック | gaidobukku | guidebook | [sound:ic_jp_guidebook.mp3]
かんこうバス | kankō basu | tour bus | [sound:ic_jp_tour-bus.mp3]
りょこうする | ryokō suru | tour | [sound:ic_jp_tour.mp3]
おてら | o-tera | temple | [sound:ic_jp_temple.mp3]
モスク | Mosuku | mosque | [sound:ic_jp_mosque.mp3]
きょうかい | kyōkai | church | [sound:ic_jp_church.mp3]
ぞう | zō | statue | [sound:ic_jp_statue.mp3]
きゅうでん | kyūden | palace | [sound:ic_jp_palace.mp3]
でぐち | deguchi | exit | [sound:ic_jp_exit.mp3]
みちじゅん | michijun | directions | [sound:ic_jp_directions.mp3]
かんこうち | kankōchi | tourist attraction | [sound:ic_jp_tourist-attraction.mp3]
ちず | chizu | map | [sound:ic_jp_map.mp3]
てはいする | tehai suru | arrange | [sound:ic_jp_arrange.mp3]
スーツケース | sūtsukēsu | suitcase | [sound:ic_jp_suitcase.mp3]
りょこうだいりてん | ryokō dairiten | travel agency | [sound:ic_jp_travel-agency.mp3]
いりぐち | iriguchi | entrance | [sound:ic_jp_entrance.mp3]
かんこうにいく | kankō ni iku | go sightseeing | [sound:ic_jp_go-sightseeing.mp3]
かんこうにいく | kankō ni iku | sightsee | [sound:ic_jp_sightsee.mp3]
かんこうする | kankō suru | go sightseeing | [sound:ic_jp_go-sightseeing.mp3]
かんこうする | kankō suru | sightsee | [sound:ic_jp_sightsee.mp3]
いっしょにいく | issho ni iku | accompany | [sound:ic_jp_accompany.mp3]
かだい | kadai | agenda | [sound:ic_jp_agenda.mp3]
どうぶつえん | dōbutsuen | zoo | [sound:ic_jp_zoo.mp3]
しゅくだい | shukudai | homework | [sound:ic_jp_homework.mp3]
かきとり | kakitori | dictation | [sound:ic_jp_dictation.mp3]
ホワイトボード | howaitobōdo | whiteboard | [sound:ic_jp_whiteboard.mp3]
こくばん | kokuban | blackboard | [sound:ic_jp_blackboard.mp3]
プロジェクター | purojekutā | projector | [sound:ic_jp_projector.mp3]
テスト | tesuto | test | [sound:ic_jp_test.mp3]
しょうテスト | shō tesuto | quiz | [sound:ic_jp_quiz.mp3]
ペン | pen | pen | [sound:ic_jp_pen.mp3]
ノート | nōto | notebook | [sound:ic_jp_notebook.mp3]
えんぴつ | enpitsu | pencil | [sound:ic_jp_pencil.mp3]
けしごむ | keshigomu | eraser | [sound:ic_jp_eraser.mp3]
こうぎ | kōgi | lecture | [sound:ic_jp_lecture.mp3]
じゅぎょう | jugyō | class | [sound:ic_jp_class.mp3]
きょうかしょ | kyōkasho | textbook | [sound:ic_jp_textbook.mp3]
もんだい | mondai | problem | [sound:ic_jp_problem.mp3]
チョーク | chōku | chalk | [sound:ic_jp_chalk.mp3]
かみ | kami | paper | [sound:ic_jp_paper.mp3]
マジック | majikku | marker | [sound:ic_jp_marker.mp3]
じしょ | jisho | dictionary | [sound:ic_jp_dictionary.mp3]
きょうしつ | kyōshitsu | classroom | [sound:ic_jp_classroom.mp3]
がっこう | gakkō | school | [sound:ic_jp_school.mp3]
がっこうのいす | gakkō no isu | school chair | [sound:ic_jp_school-chair.mp3]
がっこうのつくえ | gakkō no tsukue | school desk | [sound:ic_jp_school-desk.mp3]
おそい | osoi | late | [sound:ic_jp_late.mp3]
しゅっせきする | shusseki suru | attend | [sound:ic_jp_attend.mp3]
じゅぎょうにしゅっせきする | jugyō ni shusseki suru | attend | [sound:ic_jp_attend.mp3]
じゅぎょうにしゅっせきする | jugyō ni shusseki suru | attend | [sound:ic_jp_attend.mp3]
つく | tsuku | arrive | [sound:ic_jp_arrive.mp3]
こうぎにしゅっせきする | kougi ni shusseki suru | attend a lecture | [sound:ic_jp_attend-a-lecture.mp3]
こたえる | kotaeru | answer | [sound:ic_jp_answer.mp3]
おしえる | oshieru | teach | [sound:ic_jp_teach.mp3]
しけんをうける | shiken o ukeru | take a test | [sound:ic_jp_take-a-test.mp3]
しつもんする | shitsumon suru | ask | [sound:ic_jp_ask.mp3]
おくれる | okureru | be late | [sound:ic_jp_be-late.mp3]
ぶんをつくる | bun o tsukuru | make a sentence | [sound:ic_jp_make-a-sentence.mp3]
しめる | shimeru | close | [sound:ic_jp_close.mp3]
かせんをひく | kasen o hiku | underline | [sound:ic_jp_underline.mp3]
けす | kesu | erase | [sound:ic_jp_erase.mp3]
あける | akeru | open | [sound:ic_jp_open.mp3]
きく | kiku | listen | [sound:ic_jp_listen.mp3]
テストにごうかくする | tesuto ni gōkaku suru | pass a test | [sound:ic_jp_pass-a-test.mp3]
けっせきする | kesseki suru | absent | [sound:ic_jp_absent.mp3]
ゆっくりおねがいします。 | Yukkuri o-negai shimasu. | Slower, please. | [sound:ic_jp_Slower,-please..mp3]
わかりません。 | Wakarimasen. | I don't understand. | [sound:ic_jp_I-don't-understand..mp3]
もういちどおねがいします。 | Mō ichi-do onegai shimasu. | Once again, please. | [sound:ic_jp_Once-again,-please..mp3]
むずかしいです。 | Muzukashii desu. | It's difficult. | [sound:ic_jp_It's-difficult..mp3]
てんいん | ten'in | clerk | [sound:ic_jp_clerk.mp3]
けいさつかん | keisatsukan | police officer | [sound:ic_jp_police-officer.mp3]
けいさつかん | keisatsukan | policeman | [sound:ic_jp_policeman.mp3]
けいかん | keikan | police officer | [sound:ic_jp_police-officer.mp3]
けいかん | keikan | policeman | [sound:ic_jp_policeman.mp3]
かいしゃいん | kaishain | office worker | [sound:ic_jp_office-worker.mp3]
のうか | nōka | farmer | [sound:ic_jp_farmer.mp3]
りょうりにん | ryōrinin | cook | [sound:ic_jp_cook.mp3]
しゅふ | shufu | housewife | [sound:ic_jp_housewife.mp3]
しゅふ | shufu | homemaker | [sound:ic_jp_homemaker.mp3]
しゅふ | shufu | housewife | [sound:ic_jp_housewife.mp3]
しゅふ | shufu | homemaker | [sound:ic_jp_homemaker.mp3]
こういん | kōin | factory worker | [sound:ic_jp_factory-worker.mp3]
エンジニア | enjinia | engineer | [sound:ic_jp_engineer.mp3]
しょうぼうし | shōbōshi | firefighter | [sound:ic_jp_firefighter.mp3]
ひしょ | hisho | secretary | [sound:ic_jp_secretary.mp3]
マネージャー | manējā | manager | [sound:ic_jp_manager.mp3]
かいしゃいん | kaishain | company worker | [sound:ic_jp_company-worker.mp3]
ビジネスマン | bijinesuman | businessman | [sound:ic_jp_businessman.mp3]
きょうじゅ | kyōju | professor | [sound:ic_jp_professor.mp3]
プログラマー | puroguramā | programmer | [sound:ic_jp_programmer.mp3]
セールスマン | sērusuman | salesman | [sound:ic_jp_salesman.mp3]
ぎんこういん | ginkōin | banker | [sound:ic_jp_banker.mp3]
デザイナー | dezainā | designer | [sound:ic_jp_designer.mp3]
げいじゅつか | geijutsuka | artist | [sound:ic_jp_artist.mp3]
へいし | heishi | soldier | [sound:ic_jp_soldier.mp3]
きぎょうか | kigyōka | entrepreneur | [sound:ic_jp_entrepreneur.mp3]
けんせつさぎょういん | kensetsu sagyōin | construction worker | [sound:ic_jp_construction-worker.mp3]
せいびし | seibishi | mechanic | [sound:ic_jp_mechanic.mp3]
オフィス | ofisu | office | [sound:ic_jp_office.mp3]
どうりょう | dōryō | coworker | [sound:ic_jp_coworker.mp3]
しょるい | shorui | document | [sound:ic_jp_document.mp3]
つくえ | tsukue | desk | [sound:ic_jp_desk.mp3]
ファックス | fakkusu | fax machine | [sound:ic_jp_fax-machine.mp3]
コピーき | kopīki | copy machine | [sound:ic_jp_copy-machine.mp3]
ルーター | rūtā | router | [sound:ic_jp_router.mp3]
ふうとう | fūtō | envelope | [sound:ic_jp_envelope.mp3]
ディーブイディー | dībuidī | DVD | [sound:ic_jp_DVD.mp3]
ホッチキスのしん | hotchikisu no shin | staple | [sound:ic_jp_staple.mp3]
ホッチキス | hotchikisu | stapler | [sound:ic_jp_stapler.mp3]
ペーパークリップ | pēpā kurippu | paper clip | [sound:ic_jp_paper-clip.mp3]
シーディー | shīdī | CD | [sound:ic_jp_CD.mp3]
フォルダー | forudā | folder | [sound:ic_jp_folder.mp3]
しょうがっこう | shōgakkō | elementary school | [sound:ic_jp_elementary-school.mp3]
ちゅうがっこう | chūgakkō | middle school | [sound:ic_jp_middle-school.mp3]
こうこう | kōkō | high school | [sound:ic_jp_high-school.mp3]
だいがく | daigaku | university | [sound:ic_jp_university.mp3]
だいがく | daigaku | college | [sound:ic_jp_college.mp3]
がくひ | gakuhi | tuition fee | [sound:ic_jp_tuition-fee.mp3]
としょかん | toshokan | library | [sound:ic_jp_library.mp3]
たいいくかん | taiikukan | gym | [sound:ic_jp_gym.mp3]
がくねん | gakunen | school year | [sound:ic_jp_school-year.mp3]
やすみ | yasumi | school holiday | [sound:ic_jp_school-holiday.mp3]
きゅうか | kyūka | vacation | [sound:ic_jp_vacation.mp3]
なつやすみ | natsuyasumi | summer vacation | [sound:ic_jp_summer-vacation.mp3]
かきこうしゅう | kaki kōshū | summer school | [sound:ic_jp_summer-school.mp3]
きまつしけん | kimatsu shiken | final | [sound:ic_jp_final.mp3]
がくぶ | gakubu | department | [sound:ic_jp_department.mp3]
こうちょう | kōchō | principal | [sound:ic_jp_principal.mp3]
リュック | ryukku | backpack | [sound:ic_jp_backpack.mp3]
がびょう | gabyō | tack | [sound:ic_jp_tack.mp3]
ボールペン | bōrupen | ballpoint pen | [sound:ic_jp_ballpoint-pen.mp3]
シャーペン | shāpen | mechanical pencil | [sound:ic_jp_mechanical-pencil.mp3]
じょうぎ | jōgi | ruler | [sound:ic_jp_ruler.mp3]
しん | shin | lead | [sound:ic_jp_lead.mp3]
せっちゃくざい | secchakuzai | glue | [sound:ic_jp_glue.mp3]
しん | shin | pencil lead | [sound:ic_jp_pencil-lead.mp3]
しごとをおえる | shigoto o oeru | finish work | [sound:ic_jp_finish-work.mp3]
きぎょう | kigyō | enterprise | [sound:ic_jp_enterprise.mp3]
わりあてる | wariateru | assign | [sound:ic_jp_assign.mp3]
ざんぎょう | zangyō | overtime | [sound:ic_jp_overtime.mp3]
ぶか | buka | subordinate | [sound:ic_jp_subordinate.mp3]
しどうする | shidō suru | supervise | [sound:ic_jp_supervise.mp3]
シフト | shifuto | shift | [sound:ic_jp_shift.mp3]
たいしょくする | taishoku suru | retire | [sound:ic_jp_retire.mp3]
ほんやくする | hon'yaku suru | translate | [sound:ic_jp_translate.mp3]
アルファベット | arufabetto | alphabet | [sound:ic_jp_alphabet.mp3]
ことば | kotoba | word | [sound:ic_jp_word.mp3]
ぶん | bun | sentence | [sound:ic_jp_sentence.mp3]
げんごがく | Gengogaku | linguistics | [sound:ic_jp_linguistics.mp3]
く | ku | phrase | [sound:ic_jp_phrase.mp3]
たんじょうび | tanjōbi | birthday | [sound:ic_jp_birthday.mp3]
そつぎょう | sotsugyō | graduation | [sound:ic_jp_graduation.mp3]
しょうしん | shōshin | promotion | [sound:ic_jp_promotion.mp3]
きねんび | kinenbi | anniversary | [sound:ic_jp_anniversary.mp3]
そうぎ | sōgi | funeral | [sound:ic_jp_funeral.mp3]
りょこうする | ryokō suru | travel | [sound:ic_jp_travel.mp3]
そつぎょうする | sotsugyō suru | graduate | [sound:ic_jp_graduate.mp3]
けっこん | kekkon | wedding | [sound:ic_jp_wedding.mp3]
ひっこす | hikkosu | move | [sound:ic_jp_move.mp3]
うまれる | umareru | be born | [sound:ic_jp_be-born.mp3]
しごとをえる | shigoto o eru | get a job | [sound:ic_jp_get-a-job.mp3]
しぬ | shinu | die | [sound:ic_jp_die.mp3]
しごと | shigoto | job | [sound:ic_jp_job.mp3]
たんじょう | tanjō | birth | [sound:ic_jp_birth.mp3]
こんやくする | kon'yaku　suru | engage | [sound:ic_jp_engage.mp3]
けっこんする | kekkon suru | marry | [sound:ic_jp_marry.mp3]
まつり | matsuri | festival | [sound:ic_jp_festival.mp3]
しき | shiki | ceremony | [sound:ic_jp_ceremony.mp3]
しゅうきょう | shūkyō | religion | [sound:ic_jp_religion.mp3]
イスラムきょう | Isuramukyō | Islam | [sound:ic_jp_Islam.mp3]
プロテスタント | Purotesutanto | Protestantism | [sound:ic_jp_Protestantism.mp3]
カトリック | Katorikku | Catholicism | [sound:ic_jp_Catholicism.mp3]
ヒンズーきょう | Hinzūkyō | Hinduism | [sound:ic_jp_Hinduism.mp3]
ぶっきょう | Bukkyō | Buddhism | [sound:ic_jp_Buddhism.mp3]
どうきょう | dōkyō | Taoism | [sound:ic_jp_Taoism.mp3]
せいしょ | seisho | Bible | [sound:ic_jp_Bible.mp3]
コーラン | Kōran | Quran | [sound:ic_jp_Quran.mp3]
しさい　 | shisai | priest | [sound:ic_jp_priest.mp3]
ユダヤきょう | Yudayakyō | Judaism | [sound:ic_jp_Judaism.mp3]
れきし | rekishi | history | [sound:ic_jp_history.mp3]
ちり | chiri | geography | [sound:ic_jp_geography.mp3]
せいじ | seiji | politics | [sound:ic_jp_politics.mp3]
せいぶつがく | Seibutsugaku | biology | [sound:ic_jp_biology.mp3]
かがく | kagaku | chemistry | [sound:ic_jp_chemistry.mp3]
ぶつりがく | Butsurigaku | physics | [sound:ic_jp_physics.mp3]
けいざいがく | keizaigaku | economics | [sound:ic_jp_economics.mp3]
コンピュータサイエンス | konpyūta saiensu | computer science | [sound:ic_jp_computer-science.mp3]
やくがく | yakugaku | medicine | [sound:ic_jp_medicine.mp3]
いがく | igaku | medicine | [sound:ic_jp_medicine.mp3]
きょういく | kyōiku | education | [sound:ic_jp_education.mp3]
げんご | gengo | language | [sound:ic_jp_language.mp3]
ちきゅうかがく | chikyū kagaku | earth science | [sound:ic_jp_earth-science.mp3]
かがく | kagaku | science | [sound:ic_jp_science.mp3]
しゃかいがく | Shakaigaku | sociology | [sound:ic_jp_sociology.mp3]
すうがく | sūgaku | math | [sound:ic_jp_math.mp3]
けいざい | keizai | economy | [sound:ic_jp_economy.mp3]
ほうりつ | hōritsu | law | [sound:ic_jp_law.mp3]
たいへいよう | Taiheiyō | Pacific Ocean | [sound:ic_jp_Pacific-Ocean.mp3]
たいせいよう | Taiseiyō | Atlantic Ocean | [sound:ic_jp_Atlantic-Ocean.mp3]
ほっきょくかい | Hokkyokukai | Arctic Ocean | [sound:ic_jp_Arctic-Ocean.mp3]
インドよう | Indoyō | Indian Ocean | [sound:ic_jp_Indian-Ocean.mp3]
なんきょくかい | Nankyokukai | Southern Ocean | [sound:ic_jp_Southern-Ocean.mp3]
ブリュッセル | Buryusseru | Brussels | [sound:ic_jp_Brussels.mp3]
メキシコシティ | Mekishikoshiti | Mexico City | [sound:ic_jp_Mexico-City.mp3]
マドリード | Madorīdo | Madrid | [sound:ic_jp_Madrid.mp3]
ニューデリー | Nyū Derī | New Delhi | [sound:ic_jp_New-Delhi.mp3]
とうきょうと | Tōkyō to | Tokyo | [sound:ic_jp_Tokyo.mp3]
ぺきん | Pekin | Beijing | [sound:ic_jp_Beijing.mp3]
ロンドン | Rondon | London | [sound:ic_jp_London.mp3]
ワシントンD.C | Washinton Dī Shī | Washington D.C. | [sound:ic_jp_Washington-D.C..mp3]
トロント | Toronto | Toronto | [sound:ic_jp_Toronto.mp3]
パリ | Pari | Paris | [sound:ic_jp_Paris.mp3]
シドニー | Shidonī | Sydney | [sound:ic_jp_Sydney.mp3]
バンコク | Bankoku | Bangkok | [sound:ic_jp_Bangkok.mp3]
ベルリン | Berurin | Berlin | [sound:ic_jp_Berlin.mp3]
ソウル | Sōru | Seoul | [sound:ic_jp_Seoul.mp3]
ロサンゼルス | Rosanzerusu | Los Angeles | [sound:ic_jp_Los-Angeles.mp3]
ニューヨーク | Nyū Yōku | New York | [sound:ic_jp_New-York.mp3]
ローマ | Rōma | Rome | [sound:ic_jp_Rome.mp3]
ドバイ | Dobai | Dubai | [sound:ic_jp_Dubai.mp3]
モスクワ | Mosukuwa | Moscow | [sound:ic_jp_Moscow.mp3]
オーストラリア | Ōsutoraria | Australia | [sound:ic_jp_Australia.mp3]
なんきょくたいりく | Nankyoku tairiku | Antarctica | [sound:ic_jp_Antarctica.mp3]
アジア | Ajia | Asia | [sound:ic_jp_Asia.mp3]
アフリカ | Afurika | Africa | [sound:ic_jp_Africa.mp3]
ヨーロッパ | Yōroppa | Europe | [sound:ic_jp_Europe.mp3]
きたアメリカ | Kita Amerika | North America | [sound:ic_jp_North-America.mp3]
みなみアメリカ | Minami Amerika | South America | [sound:ic_jp_South-America.mp3]
ちゅうごく | Chūgoku | China | [sound:ic_jp_China.mp3]
アメリカがっしゅうこく | Amerika gasshūkoku | United States of America | [sound:ic_jp_United-States-of-America.mp3]
インド | Indo | India | [sound:ic_jp_India.mp3]
フランス | Furansu | France | [sound:ic_jp_France.mp3]
イングランド | Ingurando | England | [sound:ic_jp_England.mp3]
カナダ | Kanada | Canada | [sound:ic_jp_Canada.mp3]
イタリア | Itaria | Italy | [sound:ic_jp_Italy.mp3]
ロシア | Roshia | Russia | [sound:ic_jp_Russia.mp3]
にほん | Nihon | Japan | [sound:ic_jp_Japan.mp3]
かんこく | Kankoku | South Korea | [sound:ic_jp_South-Korea.mp3]
ブラジル | Burajiru | Brazil | [sound:ic_jp_Brazil.mp3]
ポルトガル | Porutogaru | Portugal | [sound:ic_jp_Portugal.mp3]
スペイン | Supein | Spain | [sound:ic_jp_Spain.mp3]
メキシコ | Mekishiko | Mexico | [sound:ic_jp_Mexico.mp3]
アルゼンチン | Aruzenchin | Argentina | [sound:ic_jp_Argentina.mp3]
エジプト | Ejiputo | Egypt | [sound:ic_jp_Egypt.mp3]
シンガポール | Shingapōru | Singapore | [sound:ic_jp_Singapore.mp3]
オーストラリア | Ōsutoraria | Australia | [sound:ic_jp_Australia.mp3]
ファーストクラス | fāsutokurasu | first class | [sound:ic_jp_first-class.mp3]
ひこうき | hikōki | airplane | [sound:ic_jp_airplane.mp3]
シートベルト | shītoberuto | seat belt | [sound:ic_jp_seat-belt.mp3]
ざせきばんごう | zaseki bangō | seat number | [sound:ic_jp_seat-number.mp3]
まくら | makura | pillow | [sound:ic_jp_pillow.mp3]
きゅうめいどうい | kyūmeidōi | flotation device | [sound:ic_jp_flotation-device.mp3]
きゅうめいどうい | kyūmeidōi | life jacket | [sound:ic_jp_life-jacket.mp3]
じさ | jisa | time difference | [sound:ic_jp_time-difference.mp3]
のりものよい | norimono yoi | motion sickness | [sound:ic_jp_motion-sickness.mp3]
もうふ | mōfu | blanket | [sound:ic_jp_blanket.mp3]
エチケットぶくろ | echiketto bukuro | sick bag | [sound:ic_jp_sick-bag.mp3]
イヤホン | iyahon | earphones | [sound:ic_jp_earphones.mp3]
イヤホン | iyahon | headphones | [sound:ic_jp_headphones.mp3]
ヘッドフォン | heddofon | earphones | [sound:ic_jp_earphones.mp3]
キャビン | kyabin | cabin | [sound:ic_jp_cabin.mp3]
にもつだな | nimotsu dana | overhead storage compartment | [sound:ic_jp_overhead-storage-compartment.mp3]
ひじょうぐち | hijōguchi | emergency exit | [sound:ic_jp_emergency-exit.mp3]
つうろがわのせき | tsūro gawa no seki | aisle seat | [sound:ic_jp_aisle-seat.mp3]
まどがわのせき | mado gawa no seki | window seat | [sound:ic_jp_window-seat.mp3]
そうじゅうし | sōjūshi | pilot | [sound:ic_jp_pilot.mp3]
つみに | tsumini | freight | [sound:ic_jp_freight.mp3]
ターミナル | tāminaru | terminal | [sound:ic_jp_terminal.mp3]
とりけす | torikesu | cancel | [sound:ic_jp_cancel.mp3]
りょうがえ | ryōgae | currency exchange | [sound:ic_jp_currency-exchange.mp3]
てにもつうけとり | tenimotsu uketori | luggage pickup | [sound:ic_jp_luggage-pickup.mp3]
とうじょうけん | tōjōken | plane ticket | [sound:ic_jp_plane-ticket.mp3]
とうじょうする | tōjō suru | board | [sound:ic_jp_board.mp3]
とうじょうぐち | tōjōguchi | boarding gate | [sound:ic_jp_boarding-gate.mp3]
かくにんする | kakunin suru | confirm | [sound:ic_jp_confirm.mp3]
おくれている | okurete iru | delayed | [sound:ic_jp_delayed.mp3]
よやくする | yoyaku suru | reserve | [sound:ic_jp_reserve.mp3]
りりくする | ririku suru | take off | [sound:ic_jp_take-off.mp3]
ちゃくりくする | chakuriku suru | land | [sound:ic_jp_land.mp3]
めんぜい | menzei | duty-free | [sound:ic_jp_duty-free.mp3]
かくのうこ | kakunōko | hangar | [sound:ic_jp_hangar.mp3]
ゆうびんきょく | yūbinkyoku | post office | [sound:ic_jp_post-office.mp3]
コンビニエンスストア | konbiniensusutoa | convenience store | [sound:ic_jp_convenience-store.mp3]
けいさつしょ | keisatsusho | police station | [sound:ic_jp_police-station.mp3]
やっきょく | yakkyoku | pharmacy | [sound:ic_jp_pharmacy.mp3]
パンや | pan-ya | bakery | [sound:ic_jp_bakery.mp3]
えいがかん | eigakan | movie theater | [sound:ic_jp_movie-theater.mp3]
かりる | kariru | rent | [sound:ic_jp_rent.mp3]
かい | kai | floor | [sound:ic_jp_floor.mp3]
ひじょうかいだん | hijō kaidan | fire escape | [sound:ic_jp_fire-escape.mp3]
エレベーター | erebētā | elevator | [sound:ic_jp_elevator.mp3]
とう | tō | tower | [sound:ic_jp_tower.mp3]
たてもの | tatemono | building | [sound:ic_jp_building.mp3]
かんりにん | kanrinin | superintendent | [sound:ic_jp_superintendent.mp3]
ちょうこうそうビル | chō-kōsō biru | skyscraper | [sound:ic_jp_skyscraper.mp3]
エスカレーター | esukarētā | escalator | [sound:ic_jp_escalator.mp3]
にわ | niwa | yard | [sound:ic_jp_yard.mp3]
ゆうびんうけ | yūbin'uke | mailbox | [sound:ic_jp_mailbox.mp3]
ぶんぼうぐ | bunbōgu | stationery | [sound:ic_jp_stationery.mp3]
てがみをかく | tegami o kaku | write a letter | [sound:ic_jp_write-a-letter.mp3]
こづつみ | kozutsumi | parcel | [sound:ic_jp_parcel.mp3]
じゅうしょ | jūsho | address | [sound:ic_jp_address.mp3]
てがみをだす | tegami o dasu | post a letter | [sound:ic_jp_post-a-letter.mp3]
そくたつゆうびん | sokutatsu yūbin | express letter | [sound:ic_jp_express-letter.mp3]
そくたつゆうびん | sokutatsu yūbin | express mail | [sound:ic_jp_express-mail.mp3]
そくたつ | sokutatsu | express letter | [sound:ic_jp_express-letter.mp3]
そくたつ | sokutatsu | express mail | [sound:ic_jp_express-mail.mp3]
かきとめ | kakitome | certified mail | [sound:ic_jp_certified-mail.mp3]
うけとりにん | uketorinin | recipient | [sound:ic_jp_recipient.mp3]
にうけにん | niukenin | consignee | [sound:ic_jp_consignee.mp3]
エアメール | eamēru | airmail | [sound:ic_jp_airmail.mp3]
きって | kitte | stamp on a letter | [sound:ic_jp_stamp-on-a-letter.mp3]
てがみにきってをはる | tegami ni kitte o haru | stamp | [sound:ic_jp_stamp.mp3]
てがみにきってをはる | tegami ni kitte o haru | stamp on a letter | [sound:ic_jp_stamp-on-a-letter.mp3]
ゆうびんやさん | yūbin-ya-san | mailman | [sound:ic_jp_mailman.mp3]
かえす | kaesu | return | [sound:ic_jp_return.mp3]
ゆうびんぶつ | yūbinbutsu | mail | [sound:ic_jp_mail.mp3]
てがみ | tegami | letter | [sound:ic_jp_letter.mp3]
ふうをする | fū o suru | seal | [sound:ic_jp_seal.mp3]
ちかてつ | chikatetsu | subway | [sound:ic_jp_subway.mp3]
でんしゃ | densha | train | [sound:ic_jp_train.mp3]
バス | basu | bus | [sound:ic_jp_bus.mp3]
ろめんでんしゃ | romen densha | trolley car | [sound:ic_jp_trolley-car.mp3]
りょうきん | ryōkin | fare | [sound:ic_jp_fare.mp3]
バスてい | basutei | bus stop | [sound:ic_jp_bus-stop.mp3]
かど | kado | corner | [sound:ic_jp_corner.mp3]
ほどう | hodō | sidewalk | [sound:ic_jp_sidewalk.mp3]
うせつ | usetsu | right turn | [sound:ic_jp_right-turn.mp3]
させつ | sasetsu | left turn | [sound:ic_jp_left-turn.mp3]
こうさてん | kōsaten | intersection | [sound:ic_jp_intersection.mp3]
こうさてん | kōsaten | crossroad | [sound:ic_jp_crossroad.mp3]
こうさてん | kōsaten | intersection | [sound:ic_jp_intersection.mp3]
こうさてん | kōsaten | crossroad | [sound:ic_jp_crossroad.mp3]
りっきょう | rikkyō | overpass | [sound:ic_jp_overpass.mp3]
かどをまがる | kado o magaru | turn a corner | [sound:ic_jp_turn-a-corner.mp3]
こんでいる | konde iru | crowded | [sound:ic_jp_crowded.mp3]
はし | hashi | bridge | [sound:ic_jp_bridge.mp3]
じゅうたい | jūtai | traffic jam | [sound:ic_jp_traffic-jam.mp3]
かんじょうこうさてん | kanjō kōsaten | roundabout | [sound:ic_jp_roundabout.mp3]
あかしんごう | aka shingō | red light | [sound:ic_jp_red-light.mp3]
いちじていしひょうしき | ichiji teishi hyōshiki | stop sign | [sound:ic_jp_stop-sign.mp3]
そくどきせい | sokudo kisei | speed limit | [sound:ic_jp_speed-limit.mp3]
こうそくどうろ | kōsokudōro | highway | [sound:ic_jp_highway.mp3]
みち | michi | road | [sound:ic_jp_road.mp3]
とおり | tōri | street | [sound:ic_jp_street.mp3]
しんごう | shingō | traffic light | [sound:ic_jp_traffic-light.mp3]
まがる | magaru | turn | [sound:ic_jp_turn.mp3]
いっぽうつうこう | ippō tsūkō | one way | [sound:ic_jp_one-way.mp3]
ちゅうしゃする | chūsha suru | park | [sound:ic_jp_park.mp3]
ひろば | hiroba | square | [sound:ic_jp_square.mp3]
ほどうきょう | hodōkyō | overhead walkway | [sound:ic_jp_overhead-walkway.mp3]
ひょうしき | hyōshiki | sign | [sound:ic_jp_sign.mp3]
きっぷ | kippu | ticket | [sound:ic_jp_ticket.mp3]
きっぷ | kippu | ticket | [sound:ic_jp_ticket.mp3]
きっぷ | kippu | ticket | [sound:ic_jp_ticket.mp3]
おうふく | ōfuku | roundtrip | [sound:ic_jp_roundtrip.mp3]
きっぷうりば | kippu uriba | ticket window | [sound:ic_jp_ticket-window.mp3]
にもつけんさ | nimotsu kensa | luggage check | [sound:ic_jp_luggage-check.mp3]
とっきゅう | tokkyū | express train | [sound:ic_jp_express-train.mp3]
ふつうでんしゃ | futsū densha | local train | [sound:ic_jp_local-train.mp3]
じこくひょう | jikokuhyō | timetable | [sound:ic_jp_timetable.mp3]
きっぷのてんけん | kippu no tenken | ticket inspection | [sound:ic_jp_ticket-inspection.mp3]
かいさつぐち | kaisatsu guchi | ticket gate | [sound:ic_jp_ticket-gate.mp3]
しんかんせん | shinkansen | bullet train | [sound:ic_jp_bullet-train.mp3]
プラットホーム | purattohōmu | platform | [sound:ic_jp_platform.mp3]
れっしゃばんごう | ressha bangō | train number | [sound:ic_jp_train-number.mp3]
しゃしょう | shashō | conductor | [sound:ic_jp_conductor.mp3]
せんろ | senro | train track | [sound:ic_jp_train-track.mp3]
しょくどうしゃ | shokudōsha | dining car | [sound:ic_jp_dining-car.mp3]
ゆうせんせき | yūsenseki | handicapped seating | [sound:ic_jp_handicapped-seating.mp3]
てすりにつかまる | tesuri ni tsukamaru | hold onto the handrail | [sound:ic_jp_hold-onto-the-handrail.mp3]
せきをゆずる | seki o yuzuru | give up a seat | [sound:ic_jp_give-up-a-seat.mp3]
まちあいしつ | machiaishitsu | waiting room | [sound:ic_jp_waiting-room.mp3]
ていりゅうじょ | teiryūjo | stop | [sound:ic_jp_stop.mp3]
えき | eki | train station | [sound:ic_jp_train-station.mp3]
きっぷじどうはんばいき | kippu jidō hanbaiki | ticket machine | [sound:ic_jp_ticket-machine.mp3]
チケットうりば | chiketto uriba | ticket booth | [sound:ic_jp_ticket-booth.mp3]
のる | noru | ride | [sound:ic_jp_ride.mp3]
フェリー | ferī | ferry | [sound:ic_jp_ferry.mp3]
のりかえる | norikaeru | transfer | [sound:ic_jp_transfer.mp3]
かねをはらう | kane o harau | pay money | [sound:ic_jp_pay-money.mp3]
うんてんしゅ | untenshu | driver | [sound:ic_jp_driver.mp3]
ちかてつ | chikatetsu | metro | [sound:ic_jp_metro.mp3]
ちかてつ | chikatetsu | subway | [sound:ic_jp_subway.mp3]
ちかてつ | chikatetsu | metro | [sound:ic_jp_metro.mp3]
タクシー | takushī | taxi | [sound:ic_jp_taxi.mp3]
じてんしゃ | jitensha | bicycle | [sound:ic_jp_bicycle.mp3]
モノレール | monorēru | monorail | [sound:ic_jp_monorail.mp3]
じょうきゃく | jōkyaku | passenger | [sound:ic_jp_passenger.mp3]
めんきょしょう | menkyoshō | license | [sound:ic_jp_license.mp3]
オートバイ | ōtobai | motorbike | [sound:ic_jp_motorbike.mp3]
オートバイ | ōtobai | motorcycle | [sound:ic_jp_motorcycle.mp3]
スクーター | sukūtā | scooter | [sound:ic_jp_scooter.mp3]
ケーブルカー | kēburukā | cable car | [sound:ic_jp_cable-car.mp3]
のりもの | norimono | vehicle | [sound:ic_jp_vehicle.mp3]
ふね | fune | boat | [sound:ic_jp_boat.mp3]
ヘリコプター | herikoputā | helicopter | [sound:ic_jp_helicopter.mp3]
トラック | torakku | truck | [sound:ic_jp_truck.mp3]
げんどうきつきじてんしゃ | gendōki tsuki jitensha | moped | [sound:ic_jp_moped.mp3]
くるまにのる | kuruma ni noru | get in a car | [sound:ic_jp_get-in-a-car.mp3]
トラック | Torakku | lorry | [sound:ic_jp_lorry.mp3]
